əkəbə~dhə	əkbəndʰə
əkəɖavu~	əkɖavu~
əkərməkə	əkərmək
əkəsiirə	əksir
əkəsmatə	əkəsmat
əkəsmate	əkəsmate
əkəɭaməɳə	əkɭaməɳ
əkəɭavu~	əkɭavu~
/	əkkəɖ
əkkərəmii	əkkərmi
əkkələ	əkkəl
əkʃətə	əkʃətə
əkʃəjə	əkʃəjə
əkʃərə	əkʃərə
əkʃərəʃəhə	əkʃərəʃəhə
əkʃa~sə	əkʃa~ʃə
əkhə~ɖə	əkʰəɳɖə
əkhə~ɖitə	əkʰəɳɖit
əkhətəro	əkʰətro
əkhəbarə	əkʰbar
əkhado	əkʰaɖo
əkhatə	əkʰat
əgəɳitə	əgəɳit
əgəɳotətə	əgəɳotər
əgəɳjaʃii	əgəɳjaʃi
əgətjə	əgətjə
əgətjəta	əgətjəta
əgəməcetii	əgəmceti
əgəvaɳii	əgəmvaɳi
əgəmjə	əgəmjə
əgərəbəttii	əgərbətti
əgəvəɖə	əgvəɖ
əgau	əgau~
əgaunii	əgau~ni
əgauthii	əgautʰi
əgasii	əgasi
əgijarə	əgijar
əgijarəmu~	əgijarmu~
əgijarəsə	əgijarəs
əgijarii	əgijari
əgocərə	əgocər
əgni	əgni
əgnidahə	əgnidah
əghəru~	əgʰəru~
əcə~bo	əcəmbo
əcanəkə	əcanək
əcuukə	əcuk
əchətə	əcʰət
əchətu~	əcʰətu~
əchəbəɖa	əcʰəbɖa
əchutə	əcʰut
əchoɖo	əcʰoɖo
əɟəgərə	əɟgər
əɟəbə	əɟəb
əɟəmavəvu~	əɟmavvu~
əɟəmo	əɟmo
əɟəvaɭəvu~	əɟvaɭvu~
əɟəvaɭiiju~	əɟvaɭiɟu~
əɟəvaɭu~	əɟvaɭu~
əɟə~po	əɟəmpo
əɟaɳə	əɟaɳ
əɟaɳju~	əɟaɳyu~
əɟajəbii	əɟajəbi
əɟiirɳə	əɟirɳə
əɟejə	əɟej
əɟoɖə	əɟoɖ
əgnanə	əgnanə
əgnanii	əgnani
əʈəkə	əʈək
əʈəkəvu~	əʈəkvu~
əʈəkəɭə	əʈkəɭ
əʈəpəʈu~	əʈpəʈu~
əʈəvavu~	əʈvavu~
əʈhəvaɖikə	əʈʰvaɖik
əʈhəvaɖiju~	əʈʰvaɖiju~
əʈhə~gə	əʈʰə˜gə
əʈhʈhai	əʈʰʈʰai
əʈhʈhaɳu~	əʈʰʈʰaɳu~
əʈhʈhavənə	əʈʰʈʰavən
əʈhjotərə	əʈʰjotər
əʈhjasii	əʈʰjasi
əɖəkəvu~	əɖəkvu~
əɖəgə	əɖəg
əɖəcəɳə	əɖcəɳ
əɖətaliisə	əɖtalis
	əɖəd
əɖədhu~	əɖdʰu~
əɖəpəlu~	əɖəplu~
əɖəvu~	əɖvu~
əɖəsəʈhə	əɖsəʈʰ
əɖoəɖə	əɖoəɖ
əɖɖo	əɖɖo
əɖəɭəkə	əɖʰəɭək
əɖharə	əɖʰar
əɖhii	əɖʰi
əɳəgəmo	əɳgəmo
əɳəghəɖə	əɳgʰəɖ
əɳədharju~	əɳdʰarju~
əɳəmaniitu~	əɳmanitu~
əɳəvərə	əɳvər
əɳi	əɳi
ətithi	ətitʰi
ətirekə	ətirek
ətiitə	ətit
ətuʈə	ətuʈ
	əʈʈər
ətjə~tə	ətjəntə
ətjacarə	ətjacar
ətjare	ətjare
ətrə	ətrə
əthɖavu~	ətʰɖavu~
əthaɳu~	ətʰaɳu~
əda	əda
ədalətə	ədalət
ədavətə	ədavət
ədrəʃjə	ədrəʃjə
ədekhai	ədekʰai
ədekhu~	ədekʰu~
ədəbhutə	ədbʰut
ədhəkəcəru~	ədʰkəcru~
ədhəmə	ədʰəm
ədhəmuu	ədʰmuu~
ədhərmə	ədʰərmə
ədhəvəcə	ədʰvəc
ədhikarə	ədʰikar
ədhiiru~	ədʰiru~
ədhuru~	ədʰuru~
ədhdhərə	ədʰdʰər
ənərthə	ənərtʰə
ənə~tə	ənəntə
	ənaɟ
ənathə	ənatʰ
ənadərə	ənadər
ənamətə	ənamət
ənamii	ənami
ənijəmitə	ənijmit
əniʃcitə	əniʃcit
əniiti	əniti
ənukərəɳə	ənukərəɳ
ənukuuɭə	ənukuɭ
ənukrəmə	ənukrəm
ənubhəvə	ənubʰəv
ənubhəvii	ənubʰəvi
ənumanə	ənuman
ənuvadə	ənuvad
ənusərəvu~	ənusərvu~
ənusnatəkə	ənusnatək
ənusvarə	ənusvar
əne	əne
ənekə	ənek
ənjajə	ənjaj
əpəco	əpəco
əpəɟəʃə	əpɟəʃ
əpəmanə	əpman
əpəvadə	əpvad
əpəvitrə	əpəvitrə
əpəʃəbdə	əpʃəbdə
əpəʃukənə	əpʃukən
əpə~gə	əpə˜gə
əpasəro	əpasəro
əpuuɟə	əpuɟ
əpekʃa	əpekʃa
əprəgəʈə	g4 
əprəgəʈə	əprəgəʈ
əprijə	y 
əprijə	əprijə
əphəva	əpʰva
əphəsosə	əpʰsos
əbəɟə	əbəɟ
əbəɟopətii	əbəɟopəti
əbhəɳə	əbʰəɳ
əbhavə	əbʰav
əbhineta	əbʰineta
əbhiprajə	ay 
əbhiprajə	əbʰiprajə
əbhimanə	əbʰiman
əbhimanii	əbʰimani
əbhjasə	əbʰjasə
əmərə	əmər
əmaru~	əmaru~
əmasə	əmas
əmukə	əmuk
əmuuljə	əmuljə
əme	əme
əjogjə	əjogjə
əriiso	əriso
əre	əre
ərthə	ərtʰə
ələgə	ələg
əlii	əli
əlopə	əlop
ələukiikə	ələukik
əvədəʃa	əvdəʃa
əvənəvu~	əvnəvu~
əvəjəvə	əvəjəv
əvərodhə	əvrodʰ
əvəlokənə	əvlokən
əvəʃjə	əvʃjə
əvəsərə	əvsər
əvəsanə	əvsan
əvəɭai	əvɭai
əvəɭu~	əvɭu~
əvaɟə	əvaɟ
əvaɭu~	əvaɭu~
əvinəjə	əvinəj
əʃəktə	əʃəktə
əʃa~tə	əʃa~ntə
əʃudhdhə	əʃudʰdʰə
əʃubhə	əʃubʰ
əs°°aɖə	əʃaɖ
əsətjə	əsətjə
əsərə	əsər
əsələ	əsəl
əsəhəkarə	əsəhkar
əsəhajə	əsəhaj
əsəhjə	əsəhjə
əsə~khjə	əsəɳkʰjə
əsə~tos°ə	əsəntoʃ
əsə~bhəvə	əsəmbʰəv
əsə~mətə	əsəmmət
əsə~skarii	əsamskari
əsadhjə	əsadʰjə
əsuurə	əsur
əsthirə	əstʰirə
əspəs°ʈə	əspəʃʈə
əsvəcchə	əsvəccʰə
əsvəsthə	əsvəstʰə
əsviikarə	əsvikar
əhi~səkə	əhimsək
əhi~sa	əhimsa
əhi~	əhi~
əhi~ja~	əhi~ja~
əhoho	əhoho
əɭəkhaməɳu~	əɭkʰamɳu~
əɭəgu~	əɭgu~
ə~kurə	ə˜kurə
ə~gə	ə˜gə
ə~guuʈhii	ə˜guʈʰi
ə~guʈho	ə˜guʈʰo
ə~greɟə	ej 
ə~greɟə	ə˜gəreɟ
ə~greɟii	e@ 
ə~greɟii	ə˜gəreɟi
ə~tə	əntə
	əntər
ə~timə	əntim
ə~te	ənte
ə~dərə	əndər
ə~daɟə	əndaɟ
ə~dhapo	əndʰapo
ə~dhariiju~	əndʰariju~
ə~dhariju~	əndʰaru~
ə~boɖo	əmboɖo
ə~ʃə	əmʃ
a	a
akarə	akar
akaʃə	akaʃ
aka~kʃa	aka~kʃa
akru≤ti	akruti
akrəməɳə	m8 
akrəməɳə	akrəməɳ
akʃepə	akʃep
akhəre	akʰəre
akhəlo	akʰlo
agə	ag
agəboʈə	agboʈ
agəmə	agəm
agəlu~	aglu~
agəɭə	agəɭ
agamii	agami
agaahii	agahi
agijo	agijo
agrəhə	agrəhə
aghatə	agʰat
aghu~	agʰu~
acarə	acər
acarjə	acarjə
achu~	acʰu~
aɟə	aɟ
aɟiiɟii	aɟiɟi
aɟiivənə	aɟivən
aɟubaɟu	aɟu baɟu
aʈəlu~	aʈlu~
aʈo	aʈo
aʈhə	aʈʰ
aʈhəmə	aʈʰəm
aɖəɳii	aɖɳi
aɖətriisə	aɖətris
aɖu~	aɖu~
aɳəvu~	aɳvu~
aɳu~	aɳu~
atma	atma
athəməɳu~	atʰəmɳu~
athəməvu~	atʰəmvu~
adərə	adər
adərʃə	adərʃə
adaʃiiʃii	adaʃiʃi
adi	adi
adivasii	adivasi
adu~	adu~
adeʃə	adeʃ
adharə	adʰar
adhunikə	adʰunik
adheɖə	adʰeɖ
adhjatmikə	adʰjatmik
anə~də	anəndə
anakani	anakani
apəɳe	apɳe
apəɳe	apətti
apəmeɭe	apmeɭe
apəle	aple
apəviitii	apviti
apəvu~	apvu~
apoapə	apoap
aphəro	apʰro
aphuusə	apʰu:s
abəruu	abru
abehubə	abehub
abohəva	abohəva
abhə	abʰ
abharə	abʰar
abhasə	abʰas
abhus°əɳə	abʰuʃəɳ
amə	am
aməɟənəta	amɟənta
aməɳe	amɳe
amətemə	amtem
aməthii	amtʰi
amədanii	amdani
amənja	amnja
amərəɳə	amərəɳ
aməlii	amli
aməɭəvu~	aməɭvu~
aməntrəɳə	aməntrəɳ
ajəno	ajno
aja	aja
ajatə	ajoɟən
arətii	arti
arəparə	arpar
arə~bhə	arəmbʰə
aramə	aram
arogjə	arogjə
aropə	arop
aləvu~	alvu~
avəkə	avək
avəkarə	avkar
avəɖətə	avɖət
avəɖəvu~	avəɖvu~
avəɖu~	avɖu~
avərəda	avərda
avəvu~	avvu~
avu~	avu~
avegə	aveg
aveʃə	aveʃ
aʃəjə	aʃəj
aʃəre	aʃre
aʃəro	aʃro
aʃa	aʃa
aʃaɖhə	aʃaɖʰ
	aʃiʃ
aʃirvadə	aʃirvad
aʃcərjə	aʃcərjə
aʃrəmə	aʃrəm
aʃvaʃənə	aʃvasən
	asən
asəpasə	aspas
asəmanə	asman
astikə	astikə
aso	aso
astha	astʰa
asvadə	asvadə
ahaha	ahaha
aharə	ahar
ahiirə	ahir
ahuuti	ahuti
aɭəsə	aɭəs
aɭoʈəvu~	aɭoʈvu~
a~kə	a~k
a~kəɖo	a~kɖo
a~kəvu~	a~kvu~
a~khə	a~kʰ
a~gəɳu~	a~gɳu~
a~gəɭijatə	a~gəɭijat
a~cəkəvu~	a~cəkvu~
a~cəkii	a~cki
a~cəko	a~cko
a~ɟəvu~	a~ɟvu~
a~tərəɖu~	a~tərɖu~
a~tərəvu~	a~tərvu~
a~təriikə	a~trik
a~dolənə	a~ndolən
a~dhəɳə	a~dʰəɳ
a~bo	a~bo
a~su~	a~su~
icchəvu~	iccʰəvu~
iccha	iccʰa
iɟənerə	iɟner
iɟaro	iɟaro
iɟɟətə	iɟɟət
iʈhʈhoterə	iʈʰʈʰoter
iʈhjasii	iʈʰjasi
itərə	itər
itihasə	itihas
inamə	inam
imamə	i:mam
imarətə	i:marət
ijəɭə	i:jəɭ
ilaɟə	i:laɟ
ilajəcii	i:lajəci
iʃkə	i:ʃkə
ispitalə	i:spital
islamə	islam
indriijə	indrijə
iiɟa	iŠɟa
iiɖəlii	iŠɖli
iidə	iŠd
iidəɖu~	iŠdɖu~
iiʃanə	iŠʃan
	iŠʃvər
i	iŠsaiŠ
i	iŠʈ
ii~ɖu~	i~Šɳdu~
ukərəɖo	ukərɖo
ukəɭəvu~	ukəɭvu~
ukəɭaʈə	ukɭaʈ
ukaɭəvu~	ukaɭvu~
ukelə	ukel
ukeləvu~	ukelvu~
ukhaɳu~	ukʰaɳu~
ugaməvu~	ugamvu~
ugəraɳii	ugʰraɳi
ughəravəvu~	ugʰravvu~
ucaʈə	ucaʈ
ucapətə	ucapət
uccarə	uccar
uccarəvu~	uccarvu~
ucchəvasə	uccʰəvas
uchəɭəvu~	ucʰəɭvu~
uchaɭəvu~	ucʰaɭvu~
ucherəvu~	ucʰervu~
uɟagəro	uɟagro
uɟaɳii	uɟaɳi
uɟɟəɖə	uɟɟəɖ
uʈhəməɳu~	uʈʰəmɳu~
uʈhəvu~	uʈʰvu~
uʈhaɖəvu~	uʈʰaɖvu~
uʈha~tərii	uʈʰa~ntəri
uɖau	uɖau
uɖavəvu~	uɖavvu~
utarəvu~	utarvu~
utaru~	utaru~
utaro	utaro
utavəɭə	utavəɭ
uttəmə	uttəm
	uttər
utteɟəkə	utpətti
utpadəkə	utpadək
utpadənə	utpadən
utsəvə	utsəv
utsahə	utsah
uthəlavəvu~	utʰlavvu~
udarə	udar
udasə	udas
udahərəɳə	udahərəɳ
udghaʈənə	udgʰaʈən
uddeʃə	uddeʃə
udhdharə	udʰdʰarə
udbhəvə	udbʰəvə
udjogə	udjogə
udhərəsə	udʰrəs
udarə	udʰar
unaɭu~	unaɭu~
unaɭo	unaɭo
upəkarə	upkar
upəcarə	upcar
upəɟəvu~	upəɟvu~
upəɟavəvu~	upɟavvu~
upədeʃə	updeʃ
upənəgərə	upnəgər
upənamə	upnam
upəjogə	upjog
upərə	upər
upəra~tə	upra~t
upərii	upri
upəvasə	upvas
upəsə~harə	upsamhar
upaɖə	upaɖ
upaɖəvu~	upaɖvu~
upajə	upaj
uməda	umda
umərə	umər
uməɭəko	uməɭko
umə~gə	umə˜gə
umerəvu~	umervu~
umero	umero
uləʈavəvu~	ulʈavvu~
ulecəvu~	ulecvu~
ullekhəvu~	ullekʰ
uʃkerəvu~	uʃkervu~
u~dərə	undər
u~bəro	umbəro
uukəɭəvu~	ukəvu~
ukaɭəvu~	ukaɭəvu~
uukhəɖəvu~	ukʰəɖvu~
uukʰaɖəvu~	ukʰaɖvu~
uugərəvu~	ugərvu~
uugəvu~	ugvu~
u	ucəkvu~
uuchərəvu~	ucʰərvu~
uuɟəvəvu~	uɟəvvu~
uuɟəɭu~	uɟɭu~
uuɖəvu~	uɖvu~
uuɳəpə	uɳəp
uutərəvu~	utərvu~
uuthələvu~	utʰəlvu~
uuthəlo	utʰlo
uudhəii	udʰəi
uunə	un
uupəɟə	upəɟ
uupəɖəvu~	upəɖvu~
uubhauubhə	ubʰaubʰ
uubhu~	ubʰu~
uuləʈii	ulti
uuləʈu~	ulʈu~
uuləɭəvu~	uləɭvu~
uuhapohə	uhapoh
uu~ghə	u~˜gə
uucəkəvu~	u~cəkvu~
uu~caii	u~cai
uu~cu~	u~cu~
uu~ʈə	u~ʈ
uu~ɖaii	unɖai
uu~ɖu~	u~ɳɖu~
uu~dhiiju~	u~ndʰiju~
uudhu~	u~ndʰu~
ru≤ɟu	ruɟu
ru≤ɳə	ruɳ
ru≤tu	rutu
ru≤s°i	ruʃi
e	e
ekə	ek
ekəʈaɳu~	ekʈaɳu~
ekəɖo	ekɖo
ekəta	ekta
ekətaɭisə	ektaɭis
ekətriisə	ekətris
ekədəmə	ekdəm
ekdharu~	ekdʰaru~
ekəpəkʃii	ekpəkʃi
ekəmə	ekəm
ekəmatrə	ekmatrə
ekəmekə	ekmek
ekəragə	ekrag
ekəruupə	ekrup
ekələ/peʈu~	ekəlpeʈu~
ekələvaju~	ekəlvaju~
ekəvəgu~	ekvəgu~
ekəvcənə	ekvəcən
ekəvisə	ekvis
ekəvisə	eksəʈʰ
ekəsərəkhu~	eksərkʰu~
ekə~dərə	ekndər
ekaekə	ekaek
ekaɳu~	ekaɳu~
ekadəʃii	ekadəʃi
ekaʃii	ekaʃi
eka~kii	eka~ki
eka~tə	eka~ntə
ekiisathe	eki satʰe
ekekə	ekkek
ekotərə	ekotər
ekjaʃi	ekjaʃi
eʈəle	eʈle
ethu~	´ʈʰu~
eɖii	eɖi
eləcii	elci
evəɖu~	evɖu~
evu~	evu~
evama~	evama~
eʃə	´ʃ
əiravətə	əiravət
əiʃvərjə	əiʃvərjə
ogəɳətrisə	ogəɳtris
ogəɳjaeʃii	ogɳja ´~ʃi
ogəɳisə	ogɳis
ogəɭəvu~	øgəɭvu~
ocintu~	øcintu~
occhəvə	occʰəv
ochabolu~	ocʰabolu~
ochu~	ocʰu~
oɟarə	oɟar
oʈə	oʈ
oʈəlo	oʈlo
oʈəvu~	oʈvu~
oɖhəvu~	oɖʰvu~
orəɖo	orɖo
orəvu~	orvu~
orii	ori
oləvəvu~	oləvvu~
	osri
oʃiiku~	oʃiku~
oɭəkhə	oɭəkʰ
oɭəvu~	oɭvu~
oɭə~gəvu~	oɭə˜gəvu~
aucitjə	əucitjə
əudiicjə	əudiŠcjə
əupəcariikə	əupcarik
əus°ədhə	əuʃədʰ
əudjogikə	əudjogik
kəkko	kəkko
kəcəkəcə	kəc kəc
kəcəɖəvu~	kəcəɖvu~
kəcərapeʈii	kəcra peʈi
kəcəro	kəcro
kəcəvaʈə	kəcvaʈ
kəcaʃə	kəcaʃ
kəcu~,bərə	kəcumbər
kəcorii	kəcori
kəɟijakhorə	kəɟijakʰor
kəɟoɖu~	kəɟoɖu~
kəʈəko	kəʈko
kəʈokəʈii	kəʈokəʈi
kəʈoro	kəʈoro
kəʈhəɳə	kəʈʰəɳ
kəʈhiinə	kəʈʰin
kəʈhijaro	kəʈʰijaro
kəʈheɖo	kəʈʰeɖo
kəʈhorə	kəʈʰor
kəʈhoɭə	kəʈʰoɭ
kəɖəko	kəɖko
kəɖəvu~	kəɖvu~
kəɖakuuʈə	kəɖakuʈ
kəɖiijo	kəɖijo
kəɖii	kəɖi
kəɖu~	kəɖu~
kəɖhə~gu~	kəɖʰə˜gu
kəɖhii	kəɖʰi
kəɳə	kəɳ
kəɳəsəvu~	kəɳəsvu~
kəthəɭəvu~	kətʰəɭvu~
kətha	kətʰa
kəthakarə	kətʰakar
kədə	kəd
kədəruupu~	kədrupu~
kədavərə	kədavər
kənəɖəgətə	kənəɖgət
kənja	kənja
kəpəʈə	kəpəʈ
kəpəɖa~lətta~	kəpɖa~lətta~
kəpəɖu~	kəpɖu~
kəpəru~	kəpru~
kəpaɭə	kəpa
kəpasə	kəpas
kəpoɭə	kəpoɭ
kəphə	kəpʰ
kəbəɟiijatə	kəbəɟijat
kəbəɟo	kəbɟo
kəbərə	kəbər
kəbuutərə	kəbutər
kəmənəsiibə	kəmnəsib
kəmərə	kəmər
kəməɭə	kəməɭ
kəməɭo	kəmɭo
kəmaii	kəmai
kəmavu~	ləmavu~
kəmurətə	kəmurət
kəmotə	kəmot
	kəmosəm
kərəkəsərə	kərkəsər
kərəgərəvu~	kərgərvu~
kərəcəlo	kərəclo
kərəɟə	kərəɟ
kərəmavu~	kərmavu~
kərəvu~	kərvu~
kəra	kəra
kərarə	kərar
kərijaɳu~	kərijaɳu~
kərijavərə	kərijavər
kəruɳə	kəruɳ
kəruɳa	kəruɳa
kəruupə	kərup
kəroɖə	kəroɖ
kəroɖərəɟɟu	kəroɖrəɟɟu
kəroɭijo	kəroɭijo
kələ~kə	kələnk
kəla	kəla
kəlakə	kəlak
kəlakarə	kəlakar
kəlpəna	kəlpəna
kəlpəvu~	kəlpəvu~
kəljaɳə	kəljaɳə
kəvəjitri	kəvəjitri
kəvi	kəvi
kəʃu~	kəʃu~
kəʃu~kə	kəʃu~k
kəsərətə	kəsrət
kəsaii	kəsai
kəsoʈii	kəsoʈi
kəheɳə	kəheɳ
kəhevətə	kəhevət
kəhevu~	kəhevu~
kəhjagəru~	kəhjagəru~
kəɭətərə	kəɭtər
kəɭii	kəɭi
kəii~	kəi~
kəii~kə	kəi~k
kə~kavəʈii	kənkavaʈi
kə~ku	kənku
kə~kotərii	kənkotəri
kə~ɟusə	kənɟus
kə~ʈaɭəvu~	kənʈaɭvu~
kə~ʈaɭo	kənʈaɭo
kə~ʈhə	kəɳtʰ
kə~ʈhii	kəɳʈʰi
kə~doro	kəndoro
kə~parii	kəmpari
kə~pəvu~	kəmpvu~
kə~sarə	kəmsar
kakəɖii	kakɖi
kaka	kaka
kakaɟii	kakaɟi
kakii	kaki
kakaɟii	kakiɟi
kagəɖo	kagɖo
kagəɭə	kagəɭ
kagaroɭə	kagaroɭ
kacə	kac
kacəbo	kacbo
kacə~ɖo	kaciɳɖo
kacu~	kacu~
kaɟəɭə	kaɟəɭ
kaɟu	kaɟu
kaʈə	kaʈ
kaɖhəvu~	kaɖʰvu~
kaɳu~	kaɳu~
katərə	katər
katərəvu~	katərvu~
katərii	katri
kadəvə	kadəv
kanə	kan
kanə	kap
kapəɖə	kapəɖ
kapəlii	kapli
kapəvu~	kapvu~
kapo	kapo
kabərə	kabər
kabuu	kabu
kamə	kam
kaməcorə	kamcor
kamədarə	kamdar
kamədevə	kamdev
kamədhə~dho	kadʰndʰo
kajədo	kajdo
kajəmə	kajəm
karəkunə	karkun
karəkhanu~	karkʰanu~
karəɳə	karəɳ
karətəkə	kartək
karətusə	kartus
karəbharə	karbʰar
kalə	kal
kavətəru~	kavətru~
kavjə	kavjə
kaɭəɟii	kaɭɟi
kaɭəɟuu	kaɭɟu~
kaɭu~	laɭu~
kaɭotərii	kaɭotəri
ka~kərii	ka~kri
ka~kəro	ka~kro
ka~ʈaɭu~	ka~ʈaɭu~
ka~ʈo	ka~ʈo
ka~ʈho	ka~ʈʰo
ka~ɖu~	ka~ɳɖu~
ka~do	kaɳdo
ka~dhə	ka~ndʰə
ka~səkii	ka~ski
ka~səko	ka~sko
killo	killo
	kiʃor
kiʃorii	kiʃori
kiiʈəlii	kiʈli
kiiɖii	kiɖi
kiiɖo	kiɖo
kiimətə	kimət
kiirti	kirti
kuʈu~bə	kuʈumbə
	kuʈev
kutuhələ	kutuhəl
kudərətə	kudrət
kuɭədevə	kuɭdev
kustii	kusti
kusevaa	kuseva
kuhaɖii	kuhaɖi
kuhaɖio	kuhaɖo
ku~ɖəɭə	kuɳɖəɭ
ku~bharə	kumbʰar
ku~vaaru~	ku~varu~
kuukəɖo	kukɖo
kuukəɖii	kukɖi
kuutərii	kutri
kuutəru~	kutru~
kuutəro	kutro
kuthəlii	kutʰli
kudəvu~	kudvu~
kudavəvu~	kudavvu~
	kuvo
ku~cii	ku~ci
kuu~pəɭə	kumpəɭ
keʈəlu~	keʈlu~
keɖə	k´ɖ
kedə	k´d
kemə	k´m
kedii	k´di
kerii	k´ri
kevəɖu~	kevɖu~
kevu~	kevu~
kesərə	kesər
	kesri
keɭə	keɭ
keɭəvəɳii	keɭəvɳi
keɭəvəvu~	keɭəvvu~
keɭu~	keɭu~
koi	koi
kogəɭiiju~	køgəɭiju~
kogəɭo	køgɭo
koʈhii	koʈʰi
koɖiiju~	koɖiju~
koɖhə	koɖʰ
koɳii	køɳi
kotərəvu~	kotərvu~
kothəmiirə	kotʰmir
kothəɭii	kotʰɭi
kothəɭo	koʈʰɭo
kodaɭii	kodaɭi
konu~	kønu~
kopəru~	kopru~
komə	kom
koməvadə	komvad
korəvu~	korvu~
koləso	kolso
kolahələ	kolahəl
koʃiʃə	koʃiʃ
kohəvu~	kohvu~
koɭii	koɭi
koɭu~	koɭu~
kəutu~mbikə	kəuʈumbik
kəubha~ɖə	kəubʰa~nɖ
kəu~sə	kəums
kjare	kjare
kəja~	kja~
krurə	krurə
krodhə	krodʰə
khəkhəɖəvu~	kʰəkʰəɖvu~
khəcəkavu~	kʰəckavu~
khəcakhəcə	kʰəcakʰəc
khəccərə	kʰəccər
khəɟanəcii	kʰəɟanci
khəɟano	kʰəɟano
khəɟurə	kʰəɟur
khəɟurii	kʰəɟuri
khəɟuuro	kʰəɟuro
khəʈəkəvu~	kʰəʈəkvu~
khəʈəpəʈə	kʰəʈpəʈ
khəʈəmələ	kʰəʈməl
khəʈəmiiʈhu~	kʰəʈmiʈʰu~
khəʈəragə	kʰəʈrag
khəʈəlo	kʰəʈlo
khəʈəvəvu~	kʰəʈəvvu~
khəʈaro	kʰəʈaro
khəʈu~bəɖu~	kʰəʈumbɖu~
khəɖəkə	kʰəɖək
khəɖəkəlo	kʰəɖəklo
khəɖəkii	kʰəɖki
khəɖətələ	kʰəɖtəl
khəɖəbəcəɖu~	kʰəɖbəcɖu~
khəɖecokə	kʰəɖecok
khəɳəvu~	kʰəɳvu~
khətəro	kʰətro
khətəvəvu~	kʰətəvvu~
khəpəvu~	kʰəpvu~
khəbərə	kʰəbər
khəbho	kʰəbʰo
khəməɳə	kʰəməɳ
khəməvu~	kʰəmvu~
khəmisə	kʰəmis
khərəpəvu~	kʰərəpvu~
khərəvu~	kʰərvu~
khərabə	kʰərab
khəru~	kʰəru~
khərekhərə	kʰərekʰər
khərcə	kʰərcə
khəlasə	kʰəlas
khəlasii	kʰəlasi
khəlelə	kʰəlel
khəvasə	kʰəvas
	kʰəs
khəsəkhəsə	kʰəskʰəs
khəseɖəvu~	kʰəseɖvu~
khəɭəkhəɭə	kʰəɭ kʰəɭ
khə~kherəvu~	kʰənkʰervu~
khə~ɟərii	kʰəµɟəri
khə~ɖə	kʰəɳɖə
khə~ɖijerə	kʰəɳɖijer
khaii	kʰai
khaudhəru~	kʰaudʰəru~
khaɟəlii	kʰaɟli
khaɟu	kʰaɟu
khaʈəkii	kʰaʈki
khaʈəlo	kʰaʈlo
khaʈəvu~	kʰaʈvu~
khaʈu~	kʰaʈu~
khaɖii	kʰaɖi
khaɖo	kʰaɖo
khaɳə	kʰaɳ
khaɳijo	kʰaɳijo
khaɳu~	kʰaɳu~
khatəmurətə	kʰatmurət
khatərə	kʰatər
khatərii	kʰatri
khatavəhii	kʰatavəhi
khatu~	kʰatu~
khanəkii	kʰangi
khanu~	kʰanu~
khabociju~	kʰabociju~
khamii	kʰami
kharu~	kʰaru~
kharekə	kʰarek
khalə	kʰal
khalii	kʰali
khavu~	kʰavu~
khasə	kʰas
khasijətə	kʰasijət
khaɭə	kʰaɭ
kha~co	kʰa~co
kha~ɖə	kʰa~ɖ
kha~ɖəvu~	kʰa~ɳɖvu~
kha~sii	kʰa~si
khisəkolii	kʰiskoli
khiicəɖii	kʰicɖi
khiicokhiicə	kʰicokʰic
khiiɟəvəvu~	kʰiɟəvvu~
khiiɳə	kʰiɳ
khiirə	kʰir
khiilə	kʰil
khiiləvu~	kʰilvu~
khiissu~	kʰissu~
khurəʃii	kʰurʃi
khulaso	kʰulaso
khullu~	kʰullu~
khuʃə	kʰuʃ
khuʃənuma	kʰuʃnuma
khuʃamətə	kʰuʃamət
khuʃii	kʰuʃi
khuɟəlii	kʰuɟli
khuʈəvu~	kʰuʈvu~
khuuɳo	kʰuɳo
khuunə	kʰun
khubə	kʰub
khubii	kʰubi
khuuləvu~	kʰulvu~
khuucəvəvu~	kʰu~cəvvu~
khəcəvu~	kʰu~cvu~
khuu~dhə	kʰu~dʰ
kheɖəvu~	kʰeɖvu~
kheɖuutə	kʰeɖut
khetərə	kʰetər
khetii	kʰeti
kheratə	kʰerat
khelə	kʰel
kheləvu~	kʰelvu~
khelaɖii	kʰelaɖi
khevənaa	kʰevna
khe~caɳə	kʰ´~caɳ
khokhəru~	kʰokʰru~
khokhu~	kʰokʰu~
	kʰoɟa
khoʈə	kʰoʈ
khoʈəkəvu~	kʰoʈkavu~
khoʈu~	kʰoʈu~
	kʰoɖ
khoɖəvu~	kʰoɖvu~
khotərəvu~	kʰotərvu~
khodəvu~	kʰodvu~
khodaɳə	kʰodaɳ
khopərii	kʰopri
khobo	kʰobo
khorəvavu~	kʰorvavu~
khorakə	kʰorak
kholəvu~	kʰolvu~
khovu~	kʰovu~
khosəvu~	kʰosvu~
khoɭiiju~	kʰoɭiju~
khoɭo	kʰoɭo
gəiikalə	gəikal
gəgəɖəvu~	gəgəɖvu~
gəɟəro	gəɟro
gəɟəvu~	gəɟvu~
gəɟhələ	gəzəl
gəʈərə	gətər
gəʈhʈho	gəʈʰʈʰo
gəɖədo	gəɖdo
gəɖəbəɖə	gəɖbəɖ
gəɖəməthələ	gəɖmətʰəl
gəɖii	gəɖi
gəɖhə	gəɖʰ
gəɖhəvii	gəɖʰvi
gəɳəkarəvu~	gəɳkarvu~
gəɳəgəɳəvu~	gəɳgəɳvu~
gəɳətərii	gəɳətri
gəɳəpəti	gəɳpəti
gəɳəvu~	gəɳvu~
gəɳəveʃə	gəɳveʃ
gəɳitə	gəɳit
gəɳeʃə	gəɳeʃ
gətagəmə	gətagəm
gəti	gəti
gədjə	gədjə
gədheɖu~	gədʰeɖu~
gəpgoɭo	gəpgoo
gəpəsəpə	gəpsəp
gəppiidasə	gəppidas
gəphələtə	gəpʰlət
gəbəɖəvu~	gəbəɖvu~
gəbii	gəbi
gəbo	gəbo
gəbhəraʈə	gəbʰraʈ
gəbhəravu~	gəbʰravu~
gəbhəru~	gəbʰru~
gəmə	gəm
gəməgiinə	gəmgin
gəmmətə	gəmmət
gəməvu~	gəmvu~
gəmarə	gəmar
gərə	gər
gərəɟə	gərəɟ
gərəɟu	gərɟu
gərəɟəvu~	gərəɟvu~
gərədənə	gərdən
gərənaɭu~	gərnaɭu~
gərəbii	gərbi
gərəbo	gərbo
gərəmə	gərəm
gərəmii	gərmi
gərəvu~	gərvu~
gəriibə	gərib
gəriibai	gəribai
gəruɖə	gəruɖ
gəroɭii	gəroɭi
gərbhadhanə	gərbʰadʰan
gərbhaʃəjə	gərbʰaʃəj
	gərvə
gələkii	gəlki
gələgoʈo	gəlgoʈo
gəlii	gəli
gəluuɖiiju~	yu& 
gəluuɖiiju~	gəluɖiju~
gəlophu~	gəlopʰu~
gəlla~təlla~	gəlla~təlta~
gəllo	gəllo
gəvənə	gəvən
gəvəijo	gəvəijo
gəɭəcəʈu~	gəɭcəʈu~
gəɭəcəvu~	gəɭəcvu~
	gəɭci
gəɭəɳii	gəɭəɳi
gəɭəpəɳə	gəɭpəɳ
gəɭəvu~	gəɭvu~
gəɭaʈu~po	gəɭaʈu~po
gəɭapha~so	gəɭapʰa~so
gəɭu~	gəɭu~
gəɭju~	gəɭju~
gə~ɟii	gəµɟi
gə~dəkii	gəndki
gə~du	gəndu~
gə~dhə	gəndʰə
gə~dhavu~	gəndʰavu~
gə~bhiirə	gəmbʰir
gaɟə	gaɟ
gaɟərə	gaɟər
gaɟəviiɟə	gaɟviɟ
gaɟəvu~	gaɟvu~
gaɖii	gaɖi
gaɖhə	gaɖʰ
gaɳu~	gaɳu~
gatha	gatʰa
gadəlu~	gadlu~
gadii	gadi
gabəɖu~	gabɖu~
gamə	gam
gajəkə	gajək
gajika	gajika
galiico	galico
gavu~	gavu~
gaɭə	gaɭ
gaɭəvu~	gaɭvu~
ga~gəɖo	ga~gɖo
ga~ʈhə	ga~ʈʰ
ga~ɖu~	ga~ɖu~
giicə	gic
giitə	git
giidhə	gidʰ
giirəvii	girvi
giiro	giro
guɟərəvu~	guɟərvu~
guɟəranə	guɟran
guɟarəvu~	guɟarvu~
guʈəko	guʈko
guɳə	guɳ
guɳədos°ə	guɳdoʃ
guɳəvu~	guɳbv~
guɳakarə	guɳakar
guɳottərə	guɳottər
gunegarə	gunegar
guno	guno
gupəcupə	gupcup
	guptə
gupha	gupʰa
gumavəvu~	gumavvu~
guru	guru
gulamorə	gulmør
gulabə	gulab
gulamə	gulam
gusso	gusso
gu~ɟəvu~	guµɟvu~
gu~ɖo	guɳɖo
gu~dərə	gundər
gu~bəɟə	gumbəɟ
guuɖhə	guɖʰ
guuməɖu~	gumɖu~
guu~gəɭavu~	gu˜gəɭavu~
guu~cə	gu~c
guu~thəvu~	gu~tʰvu~
guu~dəvu~	gu~dvu~
gerəkajəde	gerkajde
gerərəste	gerrəste
gerəlabhə	gerlabʰ
gərəvəlle	gervəlle
gerəvəvu~	gerəvvu~
gerəsəməɟə	gersəməɟ
gokəɭəgajə	gokəɭgaj
gokhəlo	gokʰlo
gokhəvu~	gokʰvu~
goɟharu~	goɟʰaru~
goʈəlii	goʈli
goʈəlo	goʈlo
goʈhəɳə	gotʰəɳ
goʈhəvəvu~	goʈʰəvvu~
goʈhijəɳə	goʈʰijəɳ
godə	god
godəɖii	godɖi
godamə	godam
gobo	gobo
goma~sə	goma~s
gorə	gør
goraɳii	gøraɳi
gorii	gori
goləmalə	golmal
govaɭə	govaɭ
govaɭəɳii	govaɭəɳi
goɭə	goɭ
goɭə	gøɭ
goɭəgoɭə	goɭgoɭ
goɭəpapəɖii	goɭpapɖi
goɭəməʈoɭə	goɭməʈoɭ
goɭii	goɭi
goɭo	goɭo
gəuɳə	gəuɳ
gəurəvə	gəurəv
grəhə	grəh
gəhəɳə	grəhəɳ
gə~thə	grəntʰ
grahəkə	grahək
ghəu~	gʰəu~
ghəuvərɳu~	gʰəu~vərɳu~
ghəʈə	gʰəʈ
ghəʈəkə	gʰəʈək
ghəʈətu~	gʰəʈtu~
ghəʈəna	gʰəʈna
ghəʈəmaɭə	gʰəʈma
ghəʈəvu~	gʰəʈvu~
ghəʈəsphoʈə	gʰʈspʰoʈ
ghəʈa	gʰəʈa
ghəʈaʈopə	gʰəʈaʈop
ghəʈaɖəvu~	gʰəʈaɖvu~
ghəʈaɖo	gʰəʈaɖo
ghəʈavəvu~	gʰəʈavvu~
ghəɖətərə	gʰəɖtər
ghəɖəpəɳə	gʰəɖpəɳ
ghəɖəvu~	gʰəɖvu~
ghəɖaii	gʰəɖai
ghəɖijaɭə	gʰəɖijaɭ
ghəɖijaɭi	gʰəɖijaɭi
ghəɖo	gəɖo
ghəɳə	gʰəɳ
ghəɳu~	gʰəɳu~
ghənə	gʰən
ghəmə~ɖə	gʰəməɳɖ
ghəmə~ɖii	gʰəməɳɖi
ghərə	gʰər
ghərəkamə	gʰərkam
ghərəkhərcə	gʰərkʰərcə
ghərəgəththu	gʰərgətʰtʰu
ghərəcoɭu~	gʰərcoɭu~
ghərəɟəmaii	gʰərɟəmai
ghərəɖu~	gʰərɖu~
ghərəbarə	gʰərbar
ghərəsə~sarə	gʰərsamsar
ghərakə	gʰərak
ghəreɳu~	gʰəreɳ~
ghəvavu~	gʰəvavu~
ghəsəgəsaʈə	gʰəsgʰəsaʈ
ghəsəɖəvu~	gʰəsəɖvu~
ghəsəɖavu~	gʰəsɖavu~
ghəsərəko	gʰəsərko
ghəsavu~	gʰəsavu~
ghə~ʈə	gʰəɳʈ
ghə~ʈəɖi	gʰəɳʈɖi
ghə~ʈii	gʰəɳʈi
gha	gʰa
ghaghəro	gʰəgʰro
ghaghərii	gʰagʰri
ghaʈ	gʰaʈ
ghaʈilu~	gʰaʈilu~
ghaɳə	gʰaɳ
ghajələ	gʰajəl
gharii	gʰari
ghaləvu~	gʰalvu~
ghasə	gʰas
ghii	gʰi
ghuvəɖə	gʰuvəɖ
ghuughərii	gʰugʰri
ghuughəvəvu~	gʰugʰəvvu~
ghuuməravu~	gʰumravu~
ghuumərii	gʰumri
ghuuməvu~	gʰumvu~
ghuurəkəvu~	gʰurəkvu~
ghusəɳiju~	gʰusəɳiju~
ghuusəvu~	gʰusvu~
ghuu~ʈəɳə	gʰu~ʈəɳ
ghuu~ʈii	gʰu~ʈi
gheʈu~	gʰeʈu~
ghenə	gʰen
ghebərə	gʰebər
gherə	gʰer
gherəvu~	gʰervu~
gheru~	gʰeru~
ghelacha	gʰelcʰa
ghelu~	gʰelu~
gho	gʰo
ghoɖapuurə	gʰoɖapur
ghoɖiiju~	gʰoɖiju~
ghoɖii	gʰoɖi
	gʰoɖo
ghorə	gʰor
ghorəvu~	gʰorvu~
ghoɭəvu~	gʰoɭvu~
cəkəcəkəvu~	cəkcəkvu~
cəkəcəkiitə	cəkcəkit
cəkəɖoɭə	cəkɖoɭ
cəkətii	cəkti
cəkəlo	cəklo
cəkəlii	cəkli
cəkamu~	cəkamu~
cəkasəvu~	cəkasvu~
cəkorə	cəkor
cəkkərə	cəkkər
cəkrəmə	cəkrəm
i)0 /cəkrəvrudʰdʰi/ 	v<i)0 
cəkrakarə	akar 
cəkrakarə	cəkrakar
cəgədəvu~	cəgədvu~
cəgəɭəvu~	cəgəɭvu~
cəcəɳəvu~	cəcəɳvu~
cəʈəkəvu~	cəʈəkvu~
cəʈəɳii	cəʈɳi
cəʈəpəʈə	cəʈpəʈ
cəʈəpəʈii	cəʈpəʈi
cəʈai	cəʈai
cəɖəutərə	cəɖutər
cəɖəcəɖəvu~	cəɖcəɖvu~
cəɖətii	cəɖti
cəɖətiipəɖətii	cəɖti pəɖti
cəɖətu~	cəɖtu~
cəɖəvu~	cəɖvu~
cəɖai	cəɖai
cəɖɖii	cəɖɖi
cəɳə	cəɳ
cəɳəvu~	cəɳvu~
cəɳijo	cəɳijo
cəɳo	cəɳo
cəturə	cətur
cətura	cətura
cətura	cəturai
cəpəʈii	cəpʈi
cəpəɭə	cəpəɭ
cəpaʈii	cəpaʈi
cəpocəpə	cəpocəp
cəppu	cəppu
cəbərəkhii	cəbərkʰi
cəbərakə	cəbrak
cəbuutəro	cəbutro
cəməkə	cəmək
cəməco	cəmco
cəmətkarə	cəmətkar
cəmelii	cəmeli
cərəkə	cərək
cərəkho	cərkʰo
cərəɳə	cərəɳ
cərəbii	cərbi
cərəvu~	cərvu~
cəritrə	cəritrə
cəru	cəru
cərcəvu~	cərcvu~
cərca	cərca
cələɳə	cələɳ
cəvaɳu~	cəvaɳu~
cəsəkəvu~	cəsəkvu~
cəsəko	cəsko
cəhero	cəhero
cəɭə	cəɭ
cəɭəvəɭə	cəvəɭ
cəɭəvu~	cəɭvu~
cəɭaməɳə	cəɭaməɳ
cə~cəɭə	cəµcəɭ
cə~dənə	cəndən
cə~drə	cəndrə
cə~pələ	cəmpəl
cə~po	cəmpo
ca	ca
cakii	caki
caku	caku
cakhəvu~	cakʰvu~
caʈəvu~	caʈvu~
caʈhu~	caʈʰu~
capəlusii	caplusi
cabəkho	cabkʰo
cabuukə	cabuk
caməɖii	camɖi
caməɖu~	camɖu~
carə	car
carəɳə	carəɳ
carəpai	carpai
cəritrə	caritrə
caro	caro
calə	cal
caləcələgətə	calcəlgət
caləbaɟii	calbaɟi
caləvu~	calvu~
calakə	calak
calakii	calaki
calu	calu
cavəvu~	cavvu~
cavii	cavi
casə	cas
caɭəɳii	caɭəɳi
caɭəvu~	caɭvu~
calisə	calis
co~cə	cø~c
co~cəɖə	ca~cəɖ
co~də	ca~d
co~dənii	ca~dni
ca~dəlo	ca~dlo
ca~dii	ca~di
ca~du~	ca~du~
ca~do	ca~do
ca~pə	ca~p
ca~pəlu~	ca~plu~
cikarə	cikar
cicəjarii	cicjari
ciʈhʈhii	ciʈʰʈʰi
ciɖavu~	ciɖavu~
ci~ta	cita
citarə	citar
cittə	cittə
citto	citto
citrə	citrə
cibavəlu~	cibavlu~
cibuukə	cibuk
cirə~ɟiivii	cirənɟivi
ciragə	cirag
cihnə	cihnə
ci~təkə	cintək
ci~tənə	cintən
ci~ta	cinta
cikəɳu~	cikɳu~
ciikii	ciki
ciiku	ciku
ciɟə	ciɟ
ciiɖə	ciɖ
ciitərəvu~	citərvu~
ciitəɭo	citɭo
ciinii	cini
ciipə	cip
ciipijo	cipijo
ciibu~	cibu~
ciməɭəvu~	ciməɭvu~
ciirəvu~	cirvu~
ciirii	ciri
ciiro	ciro
ciivəʈə	civəʈ
ciisə	cis
ciithəru~	ci~tʰru~
ciithərehalə	cithʰrehal
ci~dhəvu~	ci~dʰvu~
cuukado	cukado
cuɖelə	cuɖel
cuupə	cup
cupəkiidii	cupkidi
cuupəcapə	cupcap
custə	custə
cu~galə	cu˜gal
cu~gii	cu˜gi
cu~bənə	cumbən
cu~maɭiisə	cu~maɭis
cu~moterə	cu~moter
cuukəvəvu~	cukəvvu~
cuukəvu~	cukvu~
cuugəvu~	cugvu~
cuuɖii	cuɖi
cuunii	cuni
cuuməvu~	cumvu~
cuulo	culo
cuuvu~	cuvu~
cuusəvu~	cusvu~
cu~kə	cu~k
cuu~thəvu~	cu~tʰvu~
cu~dəɖii	cu~ndɖi
cekəvu~	cekvu~
cetənə	cetən
cetəna	cetna
cetəvəɳii	cetəvɳi
cetəvəvu~	cetəvvu~
cetəvu~	cetvu~
	cen
cepə	cep
celo	celo
celo	celi
cevəɖo	cevɖo
cehə	ceh
cətənjə	cəitənjə
cətrə	cəitrə
cokə	cøk
cokəɖii	cøkɖi
cokkəsə	cokkəs
cokəsii	cøksi
cokii	cøki
cokha	cokʰa
cokhkhaii	cokʰkʰai
cokhkhu~	cokʰkʰu~
coganə	cogan
coghəɖioju~	cogʰəɖiju~
coʈə	coʈ
coʈəvu~	cøʈvu~
coɖəvu~	cøɖvu~
cotərəphə	cotərəpʰ
cotriisə	cøtris
cothə	cotʰ
codharə	codʰar
copəgu~	copəgu~
copəɖəvu~	copəɖvu~
copəɖii	copɖi
copəɖo	copɖo
copənə	copən
copaniiju~	copaniju~
comasu~	comasu~
corə	cor
corəvu~	corvu~
corəsə	corəs
coraʃii	coraʃi
corii	cori
corii	cøri
coro	cøro
coviisə	covis
cosəʈhə	cosəʈʰ
cosəlu~	coslu~
coɭəvu~	coɭvu~
coɭa	coɭa
coɭii	coɭi
cokəvu~	co~kvu~
cəudə	cəud
chə	cʰə
chəkəvu~	cʰəkvu~
chəkko	cəkko
chəchu~dərə	cʰəcʰundər
chəʈəkəvu~	cʰəʈəkvu~
chəʈəkəvu~	cʰəʈku~
chəʈhə	cʰəʈʰ
chəɖəvu~	cʰəɖvu~
chəɖa	cʰəɖa
chəɳəkəvu~	cʰəɳəkvu~
chəɳəko	cʰəɳko
chətə	cʰət
chəta~	cʰəta~
chətrii	cʰətri
chətriisə	cʰətris
chəbərəɖo	cʰəbərɖo
chəbii	cʰəbi
chəməchəmə	cʰəmcʰəm
chələ~gə	cʰələ˜gə
chəlachələ	cʰəlacʰəl
chəvviisə	cʰəvvis
chəvviisə	 <chəvviisə>  adj 
chəɭə	cʰəɭ
chə~cheɖəvu~	cʰəncʰeɖvu~
chə~də	cʰəndə
chaɳə	cʰaɳ
chaɳu~	cʰaɳu~
chatii	cʰati
chanu~	cʰanu~
chapə	cʰap
chapəru~	cʰapru~
chapəvu~	cʰapvu~
chapu~	cʰapu~
chabə	cʰab
chabəɖii	cʰabɖi
chaja	cʰaja
chalə	cʰal
chalə	cʰalək
chala~	cʰala~
chavəɳii	cʰavɳi
chavərəvu~	cʰavərvu~
chaʃə	cʰaʃ
chasəʈə	cʰasəʈʰ
cha~ʈo	cʰa~ʈo
cha~ɖəvu~	cʰa~ɖvu~
chii	cʰi
chiinəvəvu~	cʰinəvvu~
chiipə	cʰip
chuuʈə	cʰuʈ
chuuʈəkə	cʰutək
chuuʈəchaʈə	cʰuʈcʰaʈ
chuuʈəvu~	cʰuʈvu~
chuuʈacheɖa	cʰuʈacʰeɖa
chuuʈu~	cʰutu~
chuupu~	cʰupu~
chuu~dəɳu~	cʰu~ndəɳu~
chu~do	cʰu~do
chekə	cʰek
chekəvu~	cʰekvu~
cheɖətii	cʰeɖti
cheɖəvu~	cʰeɖvu~
cheɖo	cʰeɖo
chetərəvu~	cʰetərvu~
chetəraməɳə	cʰetraməɳ
chetaɭiisə	cʰetaɭis
chedə	cʰed
chedəvu~	cʰedvu~
chellu~	cʰellu~
chevəʈe	cʰevəʈe
chevəʈe	 <chevəʈe>  advb at 
chokərəmətə	cʰokərmət
chokərii	cʰokri
chokəru~	cʰokru~
chokəro	cʰokro
choɖəvu~	cʰoɖvu~
chotəru~	cʰotru~
chotəru~	cʰol
choləvu~	cʰolvu~
choterə	cʰoter
chjasii	cʰjasi
ɟə	ɟə
ɟəkatə	ɟəkat
ɟəkkii	ɟəkki
ɟəkhəmə	ɟəkʰəm
	ɟəgət
ɟəgja	ɟəgja
ɟəɖə	ɟəɖ
ɟəɖəbatoɖə	ɟəɖbatoɖ
ɟəɖəbu~	ɟəɖbu~
ɟəɖəbhərətə	ɟəɖbʰərət
ɟəɖəvu~	ɟəɖvu~
ɟəɳ	ɟəɳ
ɟəɳəvu~	ɟəɳvu~
ɟəɳavəvu~	ɟəɳavvu~
ɟəkatə	ɟətən
ɟənmə	ɟənmə
ɟənəmə	ɟənəm
ɟənməʈiipə	ɟənməʈip
ɟəpə	ɟəp
ɟəpəvu~	ɟəpvu~
ɟəməɳə	ɟəməɳ
ɟəməɳəvarə	ɟəməɳvar
ɟəməɳu~	ɟəmɳu~
ɟəməvu~	ɟəmvu~
ɟəma	ɟəma
ɟəmaii	ɟəmai
ɟəmatə	ɟəmat
ɟəmadarə	ɟəmadar
ɟəmano	ɟəmano
ɟəmiinə	ɟəmin
ɟərə	ɟər
ɟərəkhə	ɟərəkʰ
ɟəra	ɟəra
ɟələdii	ɟəldi
ɟələso	ɟəlso
ɟəlebii	ɟəlebi
ɟəlladə	ɟəllad
ɟəvə	ɟəv
ɟəvəlle	ɟəvəlle
ɟəvabə	ɟəvab
ɟəvu~	ɟəvu~
ɟəʃə	ɟəʃ
ɟəhaɟə	ɟəhaɟ
ɟə~gələ	ɟə˜gəl
ɟə~tu~	ɟəntu
ɟə~pə	ɟəmpə
ɟagərəɳə	ɟagrəɳ
ɟagəvu~	ɟagvu~
ɟaɟəmə	ɟaɟəm
ɟaɟəru~	ɟaɟru~
ɟaɟərəmanə	ɟaɟərman
ɟaɖaii	ɟaɖai
ɟaɖu~	ɟaɖu~
ɟaɳə	ɟaɳ
ɟaɳəvu~	ɟaɳvu~
ɟaɳiitu~	ɟaɳitu~
ɟaɳe	ɟaɳe
ɟatə	ɟat
ɟatəkəmaii	ɟatkəmai
ɟati	ɟati
ɟatiijə	ɟatijə
ɟate	ɟate
	ɟatra
ɟadu	ɟadu
ɟanə	ɟan
ɟanəmalə	ɟanmal
ɟanəvərə	ɟanvər
ɟanəijo	ɟanəijo
ɟapə	ɟap
ɟamə	ɟam
ɟaməphəɭə	ɟampəɭ
ɟaməvu~	ɟamvu~
ɟamiinə	ɟamin
ɟavəkə	ɟavək
ɟasuusə	ɟasus
ɟaso	ɟaso
ɟaherə	ɟaher
ɟaheratə	ɟaherat
ɟaɭə	ɟaɭ
ɟaɭəvəɳii	ɟaɭəvɳi
ɟaɭiju~	ɟaɭiju~
ɟa~ghə	ɟa~˜gə
ɟa~bu	ɟa~mbu
ɟiɟiivis°a	ɟiɟiviʃa
ɟignasa	ɟignasa
ɟidə	ɟid
ɟiddii	ɟiddi
ɟillo	ɟillo
ɟii~dəgii	ɟindgi
ɟiitə	ɟit
ɟiitəvu~	ɟitvu~
ɟiinə	ɟin
ɟiibhə	ɟibʰ
ɟiibhaɟoɖii	ɟibʰaɟoɖi
ɟiirəvəvu~	ɟirəvvu~
ɟiiru~	ɟiru~
ɟiivə	ɟiv
ɟiivəɟə~tu~	ɟivɟəntu~
ɟiivəɖu~	ɟivɖu~
ɟiivətərə	ɟivtər
ɟiivətu~	ɟivtu~
ɟiivadəja	ɟivdəja
ɟiivənə	ɟivən
ɟiivəbhəkshii	ɟivbʰəkʃi
ɟiivəleɳə	ɟivleɳ
ɟiivəvu~	ɟivvu~
ɟiivaɳu~	ɟivaɳu~
ɟiivatə	ɟivat
ɟiivatma	ɟivatma
ɟugələ	ɟugəl
ɟugarə	ɟugar
ɟugarii	ɟugari
ɟugupsa	ɟugupsa
ɟuʈhʈhu~	ɟuʈʰʈʰu~
ɟudaii	ɟudai
ɟudu~	ɟudu~
ɟunəvaɳii	ɟunvani
ɟubanii	ɟubani
ɟuməlo	ɟumlo
ɟulabə	ɟulab
ɟuvarə	ɟuvar
ɟusso	ɟusso
ɟuu	ɟu
ɟuii	ɟui
ɟuuɟə	ɟuɟ
ɟuʈhə	ɟuʈʰ
ɟuʈhu~	ɟuʈʰu~
ɟuuthə	ɟutʰ
ɟuunu~	ɟunu~
ɟeʈhə	ɟeʈʰ
ɟeʈhaɳii	ɟeʈʰaɳi
ɟelə	ɟel
ɟevəɖu~	ɟevɖu~
ɟevu~	ɟevu~
ɟehadə	ɟehad
ɟəinə	ɟain
ɟəinə	ɟəin
ɟo	ɟo
ɟoii	ɟoi-
ɟokhəmə	ɟokʰəm
ɟokhəmavu~	ɟokʰəmavu~
ɟokhəvu~	ɟokʰvu~
ɟogəvaii	ɟogvai
ɟoganuɟogə	ɟoganu~ɟog
ɟogii	ɟogi
ɟoɖə	ɟoɖ
ɟoɖəɳii	ɟoɖɳi
ɟoɖəɳiikoʃə	ɟoɖɳikoʃ
ɟoɖəvu~	ɟoɖvu~
ɟoɖakʃərə	ɟoɖakʃər
ɟoɖaɟoɖə	ɟoɖaɟoɖ
ɟoɖaɳə	ɟoɖaɳ
ɟoɖiiju~	ɟoɖiju~
ɟoɖii	ɟoɖi
ɟoɖo	ɟoɖo
ɟorə	ɟor
ɟovu~	ɟovu~
ɟjarəthii	ɟjartʰi
ɟjare	ɟjare
ɟja~	ɟja~
ɟjotə	ɟjot
ɟjotis°ii	ɟjotiʃi
ɟhəgəməgaʈə	ɟʰəgməgaʈ
ɟhəghəɖo	ɟʰəgɖo
ɟhəɟhuuməvu~	ɟʰəɟʰumvu~
ɟhəʈə	ɟʰəʈ
ɟhəʈəkəvu~	ɟʰəʈəkvu~
ɟəʈəko	ɟʰəʈko
ɟhəʈəpəʈə	ɟʰəʈpəʈ
ɟhəɖətii	ɟʰəɖti
ɟhəɖəpə	ɟʰəɖəp
ɟhəɖəpəvu~	ɟʰəɖəpvu~
ɟhəɖəpii	ɟʰəɖpi
ɟhəɳəɟhəɳə	ɟʰəɳɟʰəɳ
ɟhəpaɟhəpii	ɟʰəpaɟʰəpi
ɟhəbəkəvu~	ɟʰəbəkvu~
ɟhəbəkaro	ɟʰəbkaro
ɟhəbəkoɭəvu~	ɟʰəbkoɭvu~
ɟhəbuukəvu~	ɟʰəbukvu~
ɟhəbhəlu~	ɟʰəbʰlu~
ɟhəbhbho	ɟʰəbʰbʰo
ɟhəməvu~	ɟʰəmvu~
ɟərəmərə	ɟʰərmər
ɟhərəvu~	ɟʰərvu~
ɟhərukho	ɟʰərukʰo
ɟhəro	ɟʰəro
ɟhəɭəkəvu~	ɟʰəɭəkvu~
ɟhəɭəɟhəɭiija~	ɟʰəɭɟʰəɭija~
ɟhəɭu~ɟhəɭu~	ɟʰəɭu~ɟʰɭu~
ɟhəɭəhəɭəvu~	ɟʰəɭhəɭvu~
ɟhə~khəna	ɟʰə˜kʰəna
ɟhə~khəvavu~	ɟʰə˜kʰvavu~
ɟhə~khəvu~	ɟʰə˜kʰvu~
ɟhə~ɟhəʈə	ɟʰəµɟʰəʈ
ɟhə~ɟhavatə	ɟʰəµɟʰavat
ɟhə~ɖo	ɟəɳɖo
ɟhakəɭə	ɟʰakə
ɟhaɟhu~	ɟʰaɟʰu~
ɟhaʈəkəvu~	ɟʰaʈəkvu~
ɟhaɖə	ɟʰaɖ
ɟhaɖəvu~	ɟʰaɖvu~
ɟhaɖii	ɟʰaɖi
ɟhaɖu~	ɟʰaɖu~
ɟhaɖo	ɟʰaɖo
ɟhapəʈvu~	ɟʰapəʈvu~
ɟhapəʈu~	ɟʰapʈu~
ɟharəɳə	ɟʰarəɳ
ɟharəvu~	ɟʰarvu~
ɟhalərə	ɟʰalər
ɟhaləvu~	ɟʰalvu~
ɟhaɭə	ɟʰaɭ
ɟa~khəru~	ɟʰa~kʰru~
ɟha~ɟhərə	ɟʰa~ɟər
ɟha~ɟhərii	ɟʰa~ɟʰri
ɟha~po	ɟʰa~po
ɟhiiɳu~	ɟʰiɳu~
ɟiiləvu~	ɟʰilvu~
ɟhuukəvu~	ɟʰukvu~
ɟhuuɟhəvu~	ɟʰuɟʰvu~
ɟhu~ʈəvəvu~	ɟʰu~ʈəvvu~
ɟhuuɖəvu~	ɟʰuɖvu~
ɟhuuɖii	ɟʰuɖi
ɟuuɖo	ɟʰuɖo
ɟhu~beʃə	ɟʰumbeʃ
ɟuum]vu~	ɟʰumvu~
ɟhuurəvu~	ɟʰurvu~
ɟuuləvu~	ɟʰulvu~
ɟhulavəvu~	ɟʰulavvu~
ɟhu~pəɖu~	ɟʰu~pɖu~
ɟherə	ɟʰer
ɟherii	ɟʰeri
ɟheriilu~	ɟʰerilu~
ɟhokəvu~	ɟʰokvu~
ɟhoku~	ɟʰoku~
	ʈəkvu~
ʈəkau	ʈəkau
ʈəkavarii	ʈəkavari
ʈəko	ʈəko
ʈəkorə	ʈəkor
ʈəkorəvu~	ʈəkorvu~
ʈəkkərə	ʈəkkər
ʈəko	təko
ʈəguməgu	ʈəguməgu
ʈəcəkavəvu~	ʈəckavvu~
ʈəcəko	ʈəcko
ʈəcəlii	ʈəcli
ʈəcuukəɖu~	ʈəcukɖu~
ʈəʈarə	ʈəʈar
ʈəʈʈu	ʈəʈʈu
ʈəpəkəvu~	ʈəpəkvu~
ʈəpəkavəvu~	təpkavvu~
ʈəpəku~	ʈəpku~
ʈəpəʈəpə	ʈəpʈəp
ʈəpəlii	lI 
ʈəpəlii	ʈəpli
ʈəpoʈəpə	ʈəpoʈəp
ʈəpaʈəpii	ʈəpaʈəpi
ʈəparəvu~	ʈəparvu~
ʈəpalə	ʈəpal
ʈəpalii	ʈəpali
ʈəbukəɖu~	ʈəbukɖu~
ʈəməkəvu~	ʈəməkvu~
ʈəhuu~ko	ʈəhu~ko
ʈəɭəvəɭəvu~	ʈəɭvəɭvu~
ʈəɭəvu~	ʈəɭvu~
ʈə~kəʃaɭə	tə˜kəʃaɭ
ʈə~ʈo	ʈəɳʈo
ʈaɖhə	ʈaɖʰ
ʈaɖhu~	ʈaɖʰu~
ʈaɳu~	ʈaɳu~
ʈapəʈiipə	ʈapʈip
ʈapu	ʈapu
ʈalə	ʈal
ʈaɭəvu~	ʈaɭvu~
ʈa~kəɳii	ʈa~kɳi
ʈa~kəvu~	ʈa~kvu~
ʈa~kii	ʈa~ki
ʈa~ko	ʈa~ko
ʈa~gə	ʈa~˜g
ʈa~gəvu	ʈa~˜gvu~
ʈa~cəɳə	ʈa~cəɳ
ʈa~ʈijo	ʈa~ʈijo
ʈicavu~	ʈicavu~
ʈiʈoɖii	ʈiʈoɖi
ʈippəɳii	ʈippəɳi
ʈikəɖii	ʈikɖi
ʈiika	ʈika
ʈiikhəɭə	ʈikʰə
ʈiicəvu~	ʈicvu~
ʈiipəvu~	ʈipvu~
ʈiipu~	ʈipu~
ʈiiləɖii	ʈilɖi
ʈili	ʈili
ʈiɖoru~	ʈiɳɖoru~
ʈuukəɖii	ʈukɖi
ʈukəɖo	ʈukɖo
ʈucəko	ʈucko
	ʈuval
ʈu~kavəvu~	ʈu~kavvu~
ʈu~pəvu~	ʈu~pvu~
ʈu~po	ʈu~po
ʈekərii	ʈekri
ʈekəvvu~	ʈekəvvu~
ʈekəvu~	ʈekvu~
ʈeko	ʈeko
ʈerəvu~	ʈervu~
ʈev]	ʈev
ʈevavu~	ʈevavu~
ʈəkovu~	ʈokvu~
ʈocə	ʈoc
ʈocəvu~	ʈocvu~
ʈopəlii	ʈopli
ʈopəlo	ʈoplo
ʈopii	ʈopi
ʈopo	ʈopo
ʈoɭəkii	ʈoɭki
ʈoɭii	ʈoɭi
ʈoɭu~	ʈoɭu~
ʈhəgə	ʈʰəg
ʈhəgəvu~	ʈʰəgvu~
ʈhəgaii	ʈʰəgai
ʈhəgaru~	ʈʰəgaru~
ʈhəpəko	ko 
ʈhəpəko	ʈʰəpko
ʈhərəvu~	ʈʰərvu~
ʈhərəvu~	ʈʰərav
ʈhəravəvu~	ʈʰəravvu~
ʈhərelə	ʈʰərel
ʈhələvavu~	ʈʰəlvavu~
ʈhəsəvu~	ʈʰəsvu~
ʈhəsothəsə	ʈʰəsoʈʰəs
ʈhəɭijo	ʈʰəɭijo
ʈhə~ɖəkə	ʈʰəɳɖək
ʈhə~ɖii	ʈʰəɳɖi
ʈhə~ɖu~	tʰəɳɖu~
ʈhakorə	ʈʰakor
ʈhakorəɟii	ʈʰakorɟi
ʈhaʈhə	ʈʰaʈʰ
ʈhaʈhəɖii	ʈʰaʈʰɖi
ʈharəvu~	ʈʰarvu~
ʈhaləvəvu~	ʈʰaləvvu~
ʈhalu~	ʈʰalu~
ʈhavəku~	ʈʰavku~
ʈha~səvu~	ʈʰa~svu~
ʈhiikə	ʈʰik
ʈhi~gəravu~	ʈʰi˜gravu~
ʈhu~ʈhəvavu~	ʈʰu~ʈʰvavu~
ʈhu~ʈhu~	ʈʰu~ʈʰu~
ʈhekəɖii	ʈʰekɖi
ʈhekəɖo	ʈʰekɖo
ʈhekəvu~	ʈʰekvu~
ʈhekaɳu~	tʰekaɳu~
ʈherəʈherə	ʈʰerʈʰer
ʈherəvəvu~	ʈʰerəvvu~
ʈheləvu~	ʈʰelvu~
ʈhelo	ʈʰelo
ʈheʃə	ʈʰeʃ
ʈhokərə	ʈʰokər
ʈhokəvu~	ʈʰokvu~
ʈhokə~ʈhokə	ʈʰokəmʈʰok
ʈhoʈhə	ʈʰoʈʰ
ʈha~so	ʈʰo~so
ɖəkho	ɖəkʰo
ɖəgəməgə	ɖəgməg
ɖəgəməgəvu~	ɖəgməgvu~
ɖəgəlu~	ɖəglu~
ɖəgəlo	ɖəglo
ɖəgəvu~	ɖəgvu~
ɖəgəɭu~	ɖəgɭu~
ɖəghavu~	ɖəgʰavu~
ɖəʈʈo	ɖəʈʈo
ɖəɳəkəvu~	ɖəɳəkvu~
ɖəphəɳu~	ɖəpʰɳu~
ɖəbəlu~	ɖəblu~
ɖəbii	ɖəbi
ɖəbo	ɖəbo
ɖəmro	ɖəmro
ɖərə	ɖər
ɖərəvu~	ɖərvu~
ɖəraməɳu~	ɖəraməɳu~
ɖəraməɳu~	 <ɖəraməɳu~>  
ɖəsəvu~	ɖəsvu~
ɖəhapəɳə	ɖəhapəɳ
ɖəhapəɳə	 <ɖəhapəɳə>  neut 
ɖəhoɭəvu~	ɖəhoɭvu~
ɖəhoɭu~	ɖəhoɭu~
ɖə~khə	ɖəɳkʰə
ɖə~khəvu~	ɖə˜kʰvu~
ɖə~khiilu~	ɖəɳkʰilu~
ɖə~phaʃə	ɖəmpʰaʃ
ɖakəɳə	ɖakəɳ
ɖaku	ɖaku
ɖaghə	ɖagʰ
ɖaghiju~	ɖagʰiju~
ɖaghu~	ɖagʰu
ɖagho	ɖagʰo
ɖacu~	ɖacu~
ɖabu~	ɖabu~
ɖaberii	ɖaberi
ɖaboɖii	ɖaboɖi
ɖamə	ɖam
ɖaməvu~	ɖamvu~
ɖamaɖoɭə	ɖamaɖoɭ
ɖaɭə	ɖaɭ
ɖa~khəɭii	ɖø~kʰɭi
ɖa~gərə	ɖa~gər
ɖa~ɖə	ɖa~ɖ
ɖa~jo	ɖa~ɖijo
ɖa~ɖii	ɖa~ɳɖi
ɖukkərə	ɖukkər
ɖuu~gərə	ɖu˜gər
ɖuu~gəraɭə	ɖu˜graɭ
ɖu~gərii	ɖu˜gri
ɖu~gəɭii	ɖu˜gɭi
ɖuuco	ɖuco
ɖuubəkii	ɖubki
ɖubəvu~	ɖubvu~
ɖumo	ɖumo
ɖusəku~	ɖusku~
ɖuu~ʈii	ɖu~ʈi
ɖuu~ɖuu~	ɖuɳɖu~
ɖokə	ɖok
ɖokiju~	ɖokiju~
ɖoku~	ɖoku~
ɖoɖo	ɖoɖo
ɖobu~	ɖobu~
ɖolə	ɖol
ɖoləvu~	ɖolvu~
ɖoʃii	ɖoʃi
ɖoɭo	ɖoɭo
ɖhəgəlo	ɖʰəglo
ɖhəcupəchu	ɖʰəcupəcu
ɖhəbə	ɖʰəb
ɖhəsəɖəvu~	ɖʰəsəɖvu~
ɖhəɭəvu~	ɖʰəvu~
ɖhə~kavu~	ɖʰə˜kavu~
ɖhə~gə	ɖʰə˜g
ɖhə~ɖhero	ɖʰəɳɖʰero
ɖhə~ɖhoɭəvu~	ɖʰəɳɖʰoɭvu~
ɖhakəɖhoɭə	ɖʰakɖʰoɭ
ɖhalə	ɖʰal
ɖhalə	ɖʰaɭ
ɖhaɭəvu~	ɖʰaɭvu~
ɖha~kəɳə	ɖʰa~kəɳ
ɖha~kəɳu~	ɖʰa~kɳu~
ɖhakəvu~	ɖʰa~kvu~
ɖhiilə	ɖʰil
ɖhiilu~	ɖʰilu~
ɖhii~gəlii	ɖʰi˜gli
ɖhii~cəɳə	ɖʰi~cəɳ
ɖhii~cəvu~	ɖʰi~cvu~
ɖhebəru~	ɖʰebru~
ɖhokəɭii	ɖʰokɭi
ɖhokəɭu~	ɖʰokɭu~
ɖhorə	ɖʰor
ɖhoɭə	ɖʰol
ɖholii	ɖʰoli
ɖhoɭə	ɖʰoɭ
ɖhoɭəvu~	ɖʰoɭvu~
ɖho~gə	ɖʰø~˜gə
təkə	tək
təkətəkəvu~	təktəkvu~
təkərarə	təkrar
təkəladii	təkladi
təkəliiphə	təklipʰ
təkiijo	təkijo
təkedarii	təkedari
təkhəto	təkʰto
təgəɖo	təgɖo
təgətəgəvu~	təgtəgvu~
təgaru~	təgaru~
təgeɖəvu~	təgeɖvu~
təɟə	təɟ
təɟəviiɟə	təɟviɟ
təɟəvu~	təɟvu~
təɟəgnə	təɟəgnə
təʈə	təʈ
təʈəsthə	təʈəstʰə
təɖə	təɖ
təɖəko	təɖko
təɖəphəɖə	təɖpʰəɖ
təɖəphəɖəvu~	təɖpʰəɖvu~
təɖamarə	təɖamar
təɳəkhəlu~	təɳəkʰəlu~
təɳəkho	təɳkʰo
təɳavu~	təɳavu~
tətəkalə	tətkal
tətəɖavəvu~	tətɖavvu~
tətvə	tətvə
tətvəgnanə	tətvəgnanə
tətvəgnanii	tətvəgnani
tətha	tətʰa
təthapi	tətʰapi
tədəupəra~tə	tədupra~t
tənə	tən
təpəkhiirə	təpkʰir
təpəvu~	təpvu~
təpasə	təpas
təpasəvu~	təpasvu~
təpelii	təpeli
təphəɖə~cii	təpʰɖəµci
təphəɖavəvu~	təpʰɖavvu~
təphavətə	təpʰavət
təbəkko	təbəkko
təbijətə	təbijət
təbiibə	təbib
təbelo	təbelo
təməru~	təmru~
təmə~co	təməµco
təmaku~	təmaku~
təmaco	təmaco
təmamə	təmam
təmaru~	təmaru~
təmaʃo	təmaʃo
təme	təme
tərəchoɖəvu~	tərcʰoɖvu~
tərətə	tərət
tərəpheɳə	tərpʰeɳ
tərəvəraʈə	tərvəraʈ
tərəvu~	tərvu~
tərə~gə	tərə˜gə
tərə~gi	tərə˜gi
tərapə	tərap
təriike	tərike
təruɳə	təruɳ
tərkə	tərkə
tərkəʃastrə	tərkəʃastrə
tələ	təl
tələpə	tələp
tələpəvu~	tələpvu~
tələvarə	təlvar
tələsa~kəɭii	təlsa~kɭi
təvariikhə	təvarikʰ
təsəviirə	təsvir
təɭəpədu~	təɭpədu~
təɭəvu~	təɭvu~
təɭaii	təɭai
tə~tu	təntu
tə~trə	təntrə
tə~trii	təntri
tə~durəstə	təndurəst
tədurəstii	təndurəsti
tə~bu	təmbu
tə~buuro	təmburo
takəvu~	takvu~
takatə	takat
tagəvu~	tagvu~
taɟə	taɟ
taɟakələmə	taɟakələm
taɟu	taɟu
taɟetərəma~	taɟetərma~
taɳə	taɳ
taɳə	ta´
taɳəvu~	taɳvu~
tatkalikə	tatkalik
tatvikə	tattvik
tapə	tap
tapəɳu~	tapɳu~
tapəvu~	tapvu~
tabəɖətobə	tabəɖtob
tarə	tar
tarəvəvu~	tarəvvu~
taraɟə	taraɟ
tariikhə	tarikʰ
taru~	taru~
taro	taro
tarkikə	tarkik
talavelii	talaveli
taliimə	talim
taluko	taluko
tavə	tav
tavəvu~	tavvu~
taviiɟə	taviɟ
taɭəvu~	taɭvu~
taɭii	taɭi
ta~təɳo	ta~tɳo
ta~trikə	ta~trik
ta~bu~	ta~bu~
tiɟorii	tiɟori
tithi	titʰi
tirəskarə	tirəskar
tiləkə	tilək
tiikhu~	tikʰu~
tiiɖə	tiɖ
tiiɳu~	tiɳu~
tiitiighoɖo	titigʰoɖo
tiirə	tir
tiirthəjatra	tirtʰjatra
tirthəsthanə	tirtʰstʰan
tiivrə	 
tiivrə	tivrə
tucchə	tuccʰə
tumakhii	tumakʰi
turətə	turət
tuləna	tulna
tula	tula
tuverə	tuver
tu~	tu~
tuʈəvu~	tuʈvu~
tutə	tut
	tutək
turu~	turu~
te	te
teɟə	teɟ
teɟəsvii	teɟəsvi
teɟabii	teɟab
teɟii	teɟi
teʈəlu~	teʈlu~
teɖəvu~	teɖvu~
teɖu~	teɖu~
teɳii	teɳi
tetaliisə	tetalis
tetriisə	tetris
təthii	teʈʰi
temə	tem
terə	ter
terəmu~	termu~
terəʃə	terəʃ
telə	tel
tetaliisə	t´~talis
te~səʈhə	t´~səʈʰ
təijarə	təijar
təijarii	təijari
to	to
tochəɖaii	tocʰɖai
tochəɖu~	tocʰɖu~
toʈo	toʈo
toɖə	toɖ
toɖəvu~	toɖvu~
totəɖu~	totɖu~
toti~gə	toti˜gə
	toter
topə	top
to pəɳə	to pəɳ
tophanə	topʰan
tophanii	topʰani
torəɳə	torəɳ
tolə	tol
tolo	tolo
toləvu~	toɭvu~
tjəɟəvu~	tjəɟvu~
tjagə	tjagə
tjagəvu~	tjagvu~
tjagii	tjagi
tjare	tjare
tjaʃii	tjaʃi
tja~	tja~
trəɳə	trəɳ
traʈəkəvu~	traʈəkvu~
traɖə	traɖ
traɳu~	traɳu~
trasə	tras
trasəvadə	trasvad
trahitə	trahit
trikoɖə	trikøɳ
tribheʈo	tribʰeʈo
trirə~gii	trirə˜gi
triiɟə	tri:ɟ
triiɟu	tri:ɟu
triisə	tris
trepənə	trepən
treviisə	trevis
tresəʈhə	tresəʈʰ
trəimasikə	trəimasik
trophəvu~	tropʰvu~
tvəca	tvəca
	tʰəɖ
thəɖəkəvu~	tʰəɖəkvu~
thəthərəvu~	tʰətərvu~
thənəgənəvu~	tʰəngənvu~
thəppi	tʰəppi
thərə	tʰər
thərəthərə	tʰərtʰər
thəvu~	tʰəvu~
thakə	tʰak
thaɳu~	tʰaɳu~
thanəkə	tʰanək
thapəʈə	tʰapəʈ
thapəɳə	tʰapəɳ
thapo	tʰap
thabəɖəvu~	tʰabəɖvu~
thaɭə	tʰaɭ
thaɭii	tʰaɭi
tha~bhəlo	tʰa~bʰlo
thiigəɖu~	tʰigɖu~
thiiɟəvu~	tʰiɟvu~
thuulii	tʰuli
thuulu~	tʰulu~
thu~kə	tʰu~k
thepəlu~	tʰeplu~
thelii	tʰeli
thelo	tʰelo
thokəɖii	tʰokɖi
thokəɖo	tʰokɖo
thokəbə~dhə	tʰokbəndʰ
thoɖu~	tʰoɖu~
thothəvavu~	tʰotʰvavu~
thothu~	tʰotʰu~
thobhəvu~	tʰobʰvu~
thorə	tʰor
dəkʃiɳə	dəkʃiɳ
dəkʃiɳa	dəkʃiɳa
dəgakhorə	dəgakʰor
dəgabaɟə	dəgabaɟ
dəgakhorii	dəgakʰori
dəgabaɟii	dəgabaɟi
dəgo	dəgo
dəɖədəɖə	dəɖ dəɖ
dəɖəbəɖə	dəɖ bəɖ
dəɖəvu~	dəɖbu~
dəɖo	dəɖo
dəduuɖii	dəduɖi
dəbədəbo	dəbdəbo
dəbaɳə	dəbaɳ
dəbavu~	dəbavu~
dəmə	dəm
dəməkəvu~	dəməkvu~
dəmədaʈii	dəmdaʈi
dəmənə	dəman
dəmamə	dəmam
dəja	dəja
dərə	dər
dərəkarə	dərkar
dərəkhastə	dərkʰastə
dərəgahə	dərgah
	dərɟi
dərəɟəɳə	dərɟəɳ
dərəɟɟo	dərəɟɟo
dərədə	dərəd
dərədii	dərdi
dərədagiino	dərdagino
dərpəɳə	dərpəɳ
dərəbarə	dərbar
dərəmijanə	dərmijan
dərəroɟə	dərroɟ
dərəvaɟo	dərvaɟo
dərəvanə	dərvan
dərəveʃə	dərveʃ
dərʃənə	dərʃən
dərʃavəvu~	dərʃavvu~
dəraɟə	dəraɟ
dərijaii	dərijai
dərijo	dərijo
dərekə	dərek
dəroɖo	dəroɖo
dəlalə	dəlal
dəlalii	dəlali
dəlitə	dəlit
dəliilə	dəlil
dəvə	dəv
dəva	dəva
dəvakhanu~	dəvakʰanu~
dəvadaru~	dəvadaru~
dəvapaɳi	dəvapani
dəʃə	dəʃ
	dəʃək
dəʃəmə	dəʃəm
dəʃəmu~	mu& 
dəʃəmu~	dəʃmu~
dəʃa	dəʃa
dəʃa~ʃə	dəʃa~ʃ
dəʃi	dəʃi
dəʃera	dəʃera
dəsə	dəs
dəsəko	dəʃko
dəstaveɟə	dəstaveɟ
dəhaɖo	dəhaɖo
dəhii~	dəhi~
dəhiitəru~	dəhi~təru~
dəhivəɖu~	dəhi~vəɖu~
dəheɟə	dəheɟ
dəheʃətə	dəheʃət
dəɭədarə	dədar
dəɭəvu~	dəɭvu~
də~gələ	də˜gəl
də~ɖə	dəɳɖə
də~ɖəvu~	dəɳɖvu~
dətəkətha	dəntkətʰa
də~təʃuɭə	dəntʃuɭ
də~pətii	dəmpəti
də~bhə	dəmbʰ
də~bhii	dəmbʰi
də~ʃə	dəmʃ
dakhəlo	dakʰlo
dagiino	dagino
daghə	dagʰ
daɟhə	daɟʰ
daɟhəvu~	daɟʰvu~
daʈəvu~	daʈvu~
daɖəmə	daɖəm
daɖhə	daɖʰ
daɖhii	daɖʰi
daɳo	daɳo
datəɳə	datəɳ
dadərə	dadər
dadəro	dadro
dadagiirii	dadagiri
dadii	dadi
dado	dado
danə	dan
danətə	danət
danəvə	danəv
daneʃərii	daneʃəri
dabəɖii	dabɖi
dabəvu~	dabvu~
dajəko	dajko
dajəɳə	dajəɳ
daruu	daru
daruukhanu~	darukʰanu~
daruɖiijo	daruɖijo
darʃənikə	darʃənik
davə	dav
davo	davo
dasə	das
dasii	dasi
daɭə	daɭ
da~tə	da~t
da~tijo	da~tijo
digdərʃəkə	digdərʃək
digmuɖhə	digmuɖʰ
dinəcərja	dincərja
dinəratə	dinrat
dimagə	dimag
dijərə	dijər
dilə	dil
diləgirə	dilgir
diləgiirii	dilgiri
diləcəʃpə	dilcəʃpə
diləcəʃpii	dilcəʃpi
dilədarə	dildar
dilaso	dilaso
divəsə	divəs
divaso	divaso
divaɭii	divaɭi
diveɖə	diveʈ
divelə	divel
divjə	divjə
diikərii	dikri
diikəro	dikro
diidii	didi
din	din
diipə	dip
diipəkə	dipək
diipəɖo	dipɖo
diipavəlii	dipavli
diirghə	dirgə
diivada~ɖii	divada~ɖi
diivalə	dival
diivasəɭii	divasəɭi
diivii	divi
diivo	divo
dukanə	dukan
dukaɭə	dukaɭ
dukhəvu~	dukʰvu~
dukhavo	dukʰavo
dukhijaru~	dukʰijaru~
duɳavu~	duɳavu~
dunija	dunija
dupəʈʈo	dupəʈʈo
dubhagəvu~	dubʰagvu~
dubhavəvu~	dubʰavvu~
dubhavu~	dubʰavu~
dubhas°ijo	dubʰaʃijo
duragrəhə	duragrəh
duracərəɳə	duracərəɳ
duracarə	duracar
duracarii	duracari
durgətii	durgəti
durgə~dhə	durgəndʰ
durbəɭə	durbəɭ
durləbhə	durləbʰ
duva	duva
duʃmənə	duʃman
duŠkhə	dukʰ
dusadhjə	dusadʰjə
duɟhəvu~	duɟʰvu~
dudhə	dudʰ
dudhija	dudʰija
dudhii	dudʰi
dubəɭu~	dubɭu~
dubhəvəvu~	dubʰəvvu~
durə	dur
durəbiinə	bIn 
durəbiinə	durbin
drəɖhə	drəɖʰ
drəs°ʈi	drəʃʈi
dekhərekhə	dekʰrekʰ
dekhəvu~	dekʰvu~
dekhadekhii	dekʰadekʰi
dekhavə	dekʰav
dekhavəɖu~	dekʰavɖu~
dekhavu~	dekʰavu~
dekhiitu~	dekʰitu~
deɖəkii	deɖki
deɖəku~	deɖku~
deɖəko	deɖko
deraɳii	deraɳi
derasərə	derasər
derii	deri
devə	dev
devəta	devta
devənagərii	devnagri
	devəɭ
devadarə	devadar
devaɭiiju~	devaɭiju~
devii	devi
devu~	devu~
deʃə	deʃ
deʃəkaɭə	deʃkaɭ
deʃdaɟhə	deʃdaɟʰ
deʃəʈənə	deʃaʈən
deʃii	deʃi
dehə	deh
dehətjagə	dehtjag
dəinikə	dəinik
dəivii	dəivi
doʈə	doʈ
doɖə	doɖ
doɖədhamə	doɖdʰam
doɖəvu~	doɖvu~
doɖadoɖə	doɖadoɖ
doɖhə	ɖoɖʰ
doɖhəɖahju~	doɖʰɖahju~
doɖhu~	doɖʰu~
dodəɭu~	dodɭu~
dorəɖii	dorɖi
dorəɖu~	dorɖu~
dorəvəɖii	dorəvɳi
dorəvu~	dorvu~
dorii	dori
doro	doro
dos°ə	doʃ
dostə	dost
dohəvu~	dohvu~
dohitrə	dohitrə
dohitrii	dohitri
drakʃha	drakʃ
drohə	droh
dvipa	dvip
dwəimasikə	dvəimasik
dəkeləvu~	dʰəkelvu~
dhəkko	dʰəkko
dhəgəʃə	dʰəgəʃ
	dʰəɟa
dhəɖə	dʰəɖ
dhəɖəkə	dʰəɖək
dhəɖəkəvu~	dʰəɖəkvu~
dhəɖako	dʰəɖako
dhɖadhəɖə	dʰəɖadʰəɖ
dhəɖadhəɖii	dʰəɖadʰəɖi
dhəɳə	dʰəɳ
dhəɳii	dʰəɳi
dhəɳiijaɳii	dʰəɳijaɳi
dhəti~gə	dʰəti˜gə
dhənə	dʰən
dhənəterəʃə	dʰənterəʃ
dhənuʃjə	dʰənuʃjə
dhənjə	dʰənjə
dhəbəɖəko	dʰəbəɖko
dhəməkəvu~	dʰəməkvu~
dhəməkavu~	dʰəmkavvu~
dhəməkii	dʰəmki
dhəməni	dʰəmni
dhəmalə	dʰəmal
dhərətii	dʰərti
dhərəpəkəɖə	dʰərpəkəɖ
dhərəbəvu~	dʰərəbvu~
dhərəmuuɭə	dʰərmu
dhərəvu~	dʰərvu~
dhəravu~	dʰəravu~
dhərii	dʰəri
dhəro	dʰəro
dhərmə	dʰərmə
dhərməguru	dʰərməguru
dhərmatma	dʰərmatma
dhərmada	dʰərmada
dhərmantərə	dʰərmantər
dhərma~dhə	dʰərmandʰə
dhərmis°ʈə	dʰərmiʃʈ
dhəsəməsə	dʰəsməs
dhəsəvu~	dʰəsvu~
dhəsaro	dʰəsaro
dhə~dho	dʰəndʰo
dhakə	dʰak
dhaɖə	dʰaɖ
dhaɖəpaɖu	dʰaɖpaɖu
dhaɳii	dʰaɳi
dhatu	dʰatu
dhanə	dʰan
dhabu~	dʰabu~
dhamə	dʰam
dhamədhumə	dʰamdʰum
dhamo	dʰamo
dharə	dʰar
dharəɳa	dʰarɳa
dharəvu~	dʰarvu~
dharaʃaʃtrii	dʰaraʃaʃtri
dharasabha	dʰarasəbʰa
dharo	dʰaro
dharmikə	dʰarmik
dhavəɳə	dʰavəɳ
dhavəvu~	dʰavvu~
dha~dhələ	dʰa~dʰəl
dhikkarəvu~	dʰikavvu~
dhikkarə	dʰikkar
dhiimu~	dʰimu~
dhiimu~	dʰime
dhiimethii	dʰimetʰi
dhirəɟə	dʰirəɟ
dhirədharə	dʰirdʰar
dhiirəvu~	dʰirvu~
dhutarii	dʰutari
dhutaro	dʰutaro
dhupelə	dʰupel
dhumaɖiju~	dʰumaɖiju~
dumaɖo	dʰumaɖo
dhuuɳəvu~	dʰuɳvu~
dhuutəvu~	dʰutvu~
dhuunə	dʰun
dhuupə	dʰup
dhupəsəɭii	dʰupsəɭi
dhuuɭə	dʰuɭ
dhuu~apuu~a	dʰu~apu~a
dhu~dhəvavu~	dʰu~ndʰvavu~
dhu~dhəɭu~	dʰu~dʰɭu~
dhu~sərii	dʰu~sri
dokaʈəvu~	dʰokaʈvu~
dhoko	dʰoko
dhotiju~	dʰotiju~
dhotii	dʰoti
dhodhə	dʰodʰ
dhobəɳə	dʰobəɳ
dhobii	dʰobi
dhorəɳə	dʰorəɳ
dholaii	dʰolai
dhovaɳə	dʰovaɳ
dhovu~	dʰovu~
dhoɭə	dʰoɭ
dhoɭu~	dʰoɭu~
dhjnə	dʰjanə
dhjejə	dʰjej
dhruɟarii	dʰruɟari
dhvəɟə	d´vəɟ
dhvəni	dʰvani
nəkələ	nəkəl
nəkəlii	nəkli
nəkəʃiikamə	nəkʃikam
nəkəʃo	nəkʃo
nəkamu~	nkamu~
nəkarə	nəkar
nəkuuco	nəkuco
nəkorəɖo	nəkorɖo
nəkkərə	nəkkər
nəkki	nəkki
nəkʃətrə	nəkʃətrə
nəkhə	nəkʰ
nəkhəraɭu~	nəkʰraɭu~
nəkhərabaɟə	nəkʰra~baɟ
nəkhəru~	nəkʰru~
nəkhəlii	nəkʰli
nəkhəʃikhə	nəkʰʃikʰ
nəkhokhodə	nəkʰkʰod
nəgəɳu~	nəgəɳu~
nəgədə	nəgəd
nəgərə	nəgər
nəgərii	nəgri
nəgəru~	nəgru~
nəgnə	nəgnə
nəci~tə	nəci~nt
nachuutəke	nəcʰuʈke
nəɟədiikə	nəɟdik
nəɟərə	nəɟər
nəɟəraɳu~	nəɟraɳu~
nəɟəraɳu~	nəɟravu~
nəɟiikə	nəɟik
nəɟiivu~	nəɟivu~
nəʈə	nəʈ
nəʈii	nəʈi
nəʈharu~	nəʈʰaru~
nəʈhorə	nəʈʰor
nəɖətərə	nəɖtər
nəɳədələ	nəɳdəl
nəɳədii	nəɳdi
nəɳədoii	nəɳdoi
nətiiɟo	nətiɟo
nə~ɳədə	nəɳənd
nəthə	nətʰ
nəthii	tətʰi
nədii	nədi
nənamii	nənami
nənamu~	nənamu~
nənno	nənno
nəpasə	nəpas
nəpu~səkə	nəpu~msək
nəphəkəru~	nəpʰəkru~
nəphphəʈə	nəpʰpʰəʈ
nəphakhorə	nəpʰakʰor
nəpho	nəpʰo
nəbəɭaii	nəbɭai
nəbəɭu~	nəbɭu~
nəbapu~	nəbapu~
nəbhə	nəbʰ
nəbhəvu~	nəbʰvu~
nəməkə	nəmək
nəməɳu~	nəmɳu~
nəmənə	nəmən
nəməvu~	nəmvu~
nəmaɟə	nəmaɟ
nəmaju~	nəmaju~
nəmuuchiju~	nəmucʰiju~
nəmuuno	nəmuno
nəmrə	nəmrə
nəjənə	nəjən
nərə	nər
nərəkə	nərək
nərəɟati	nərɟati
nərtəkə	nərtək
nərtəkii	nərtəki
nəɭakarə	nəɭakar
nəɭakarə	nəv
nəvəɟuvanə	nəvɟuvan
nəvəɟiivənə	nəvɟivən
nəvəɟotə	nəvɟot
nəvətərə	nəvtər
nəvədha	nəvdʰa
nəvəraʃə	nəvraʃ
nəvəru~	nəvru~
nəvələkətha	nəvəlkətʰa
nəvəlika	nəvlika
nəvəvədhuu	nəvvədʰu
nəvəʃeku~	nəvʃeku
nəvəstru~	nəvəstru~
nəvaii	nəvai
nəvaɟəvu~	nəvaɟvu~
nəvaɟuunii	nəvaɟuni
nəviinə	nəvin
nəvu~	nəvu~
nəvesərəthii	nəvesərtʰi
nəvvaɳu~	nəvvaɳu~
nəʃo	nəʃo
nəsə	nəs
nəskoru~	nəskoru~
nəsiibə	nəsib
nəhi	nəhi
nəhivət	nəhivət
nəherə	nəher
nəhorə	nəhor
nəɭiju~	nəɭiju~
nəɭii	nəɭi
nə~gə	nə˜gə
na	na
nailaɟə	nailaɟ
nakə	nak
naku~	naku~
nakhəvu~	nakʰvu~
nagə	nag
nagəɳə	nagəɳ
nagərə	nagər
nagərəvelə	nagərvel
nagərikə	nagrik
nagərii	nagri
nagu~	nagu~
nacə	nac
nacəvu~	nacvu~
nachuuʈəke	nacʰuʈke
naɟukə	naɟuk
naʈəkə	naʈək
naʈəkəkarə	naʈəkkar
naʈəkiiju~	naʈəkiju~
naʈika	naʈika
naɖachəɖii	naɖacʰəɖi
naɖii	naɖi
naɖu~	naɖu~
naɳəvu~	naɳvu~
naɳakiijə	naɳakij
naɳabhiiɖə	naɳabʰiɖ
naɳu~	naɳu~
natə	nat
natəvəro	natvəro
natalə	natal
nato	nato
nathə	natʰ
nadanə	nadan
nadarə	nadar
nanəkhəʈaii	nankʰəʈai
nanəpə	nanəp
nanəmə	nanəm
nanəpəɳə	nanpəɳ
nanu~	nanu~
napasə	napas
nabhi	nabʰi
namə	nam
naməciinə	namcin
naməʈhamə	namʈʰam
namədarə	namdar
naməna	namna
namu~	namu~
najəkə	najək
najika	najika
narə~gii	narə˜gi
naraɟə	naraɟ
narijeɭə	narijeɭ
narii	nari
nalajəkə	nalajək
navə	nav
navikə	navik
naʃə	naʃ
nasə	nas
nasəpəti	naspəti
nasəbhagə	nasbʰag
nasəvu~	nasvu~
nasto	nasto
nahəkə	nahək
nahəvu~	nahvu~
naɭə	naɭ
naɭəcu~	naɭcu~
naɭu~	naɭu~
nikalə	nikal
nikasə	nikas
nikahə	nikah
nikhaləsə	nikʰaləs
niguuɖhə	niguɖʰ
nichovəvu~	nicovcu~
niɟanə~də	niɟanənd
nitarəvu~	nitarvu~
nitjə	nitjə
nitjəkərmə	nitjəkərma
nidanə	nidan
nidhənə	nidʰən
nipuɳə	nipuɳ
nibə~dhə	nibəndʰ
nibhavəvu~	nibʰavvu~
niməɳu~kə	nimɳu~k
nimə~trəɳə	niməntrəɳ
nimə~trəvu~	niməntrəvu~
nimaɖo	nimaɖo
nijəmə	nijəm
nijəmənə	nijəmən
nijəmitə	nijəmit
nijaməkə	nijamək
nijukti	nijukti
nirəkʃərə	nirəkʃər
nirəpekʃə	nirpekʃə
nirthəkə	nirərtʰək
nirə~kuʃə	nirə˜kuʃ
nirə~tərə	nirəntər
ni,rakərəɳə	nirakərəɳ
nirakarə	nirakar
niradharə	niradʰar
nirashə	niraʃ
niraɭu~	niraɭu~
nira~tə	nira~t
nirikʃəkə	nirikʃək
niruttərə	niruttər
nirupəjogii	nirupjogi
niruupəɳə	nirupəɳ
niruupəvu~	nirupvu~
nirɟənə	nirɟən
nirɟəɭə	nirɟəɭ
nirɟiivə	nirɟiv
nirɳəjə	nirɳəj
nirɳajəkə	nirɳajək
nirdəjə	nirdəj
nirdeʃə	nirdeʃ
nirdos°ə	nirdoʃ
nirdhənə	nirdʰən
nirdharə	nirdʰar
nirbəɭə	nirbə
nirbhəjə	nirbʰəj
nirbheɭə	nirbʰe
nirməɭə	nirməɭ
nirmaɳə	nirmaɳ
nirmaljə	nirmaljə
nirmuuɭə	nirmuɭ
nirvaɳə	nirvaɳ
nirvasitə	nirvasit
nirvahə	nirvah
nirvighnə	nirvign
nivarəvu~	nivarvu~
nivasi	nivas
nivasii	nivasi
nivr≤uttə	nivruttə
nivr≤utti	nivrutti
niveɖo	niveɖo
nivedənə	nivedən
niʃanə	niʃan
niʃanii	niʃani
niʃaɭə	niʃaɭ
niʃaɭijo	niʃaɭijo
niʃcəjə	niʃcəjə
niʃcitə	niʃcit
niʃvasə	niʃvas
nis°edhə	niʃedʰ
nis°kələ~kə	niʃkala˜k
nis°kriijə	niʃkrijə
nis°ʈha	niʃʈʰa
nis°ʈhurə	niʃʈur
nis°ɳatə	niʃɳat
nis°pəkʃə	niʃpəkʃə
nis°papə	niʃpap
nis°praɳə	niʃpraɳ
nis°phəɭə	niʃpʰəl
nisərəɳii	nisərɳi
nisaso	nisaso
nisteɟə	nisteɟ
nisbətə	nisbət
niharika	niharika
nihaɭəvu~	nihaɭvu~
ni~dəvu~	nindvu~
ni~da	ninda
ni:ʃəbdə	niʃəbdə
ni:ʃəstrə	niʃəstrə
ni:ʃulkə	niʃulkə
ni:sə~tanə	nisəntan
ni:sə~dehə	nisəndeh
ni:svarthə	nisvarthə
niikə	nik
niikəɭəvu~	nikəɭvu~
niicə	nic
niicaɟoɳu~	nicaɟoɳu~
niicaɳə	nicaɳ
niicu~	nicu~
niiɖərə	niɖər
niitərəvu~	nitərvu~
niitərju~	nitrju~
niiti	niti
niitiʃastrə	nitiʃastrə
niipəɟə	nipəɟ
niipəɟəvu~	nipəɟvu~
niimə	nim
niiməvu~	nimvu~
niirəkhəvu~	nirəkʰvu~
niirəɳə	nirəɳ
niirəvə	nirəv
niirəvu~	nirvu~
niirogii	nirogi
niilə	nil
niivəɖəvu~	nivəɖvu~
nii~dəɳə	nindəɳ
nukəsanə	nuksan
nuutənə	nutən
nuurə	nur
nr≤utjə	nrutjə
nekə	nek
neta	neta
netagiirii	netagiri
nevu~	nevu~
nevjaʃii	nevjaʃi
nəitikə	nəitik
nəiru≤tjə	nəirutjə
nəivedə	nəived
nəivedə	 <nəivedə>  masc  the 
nəisərgikə	nəisərgik
nokərə	nokər
nokərəʃahii	nokərʃahi
nokərijatə	nokərijat
notərəvu~	notərvu~
notəru~	notru~
nodharu~	nodʰaru~
nobətə	nobət
nomə	nom
noɭijo	noɭijo
no~dhə	nø~dʰ
nəuka	nəuka
nəukadəɭə	nəukadəɭ
njatə	njat
njatiilu~	njatilu~
njajə	njaj
njajadhiiʃə	njajadʰiʃ
njajii	njaji
pəkəɖə	pəkəɖ
pəkəɖəvu~	pəkəɖvu~
pəkəvəvu~	pəkəvvu~
pəkəvanə	pəkvan
pəkʃə	pəkʃə
pəkʃaghatə	pəkʃagʰat
pəkʃəpatə	pəkʃəpat
pəkʃapəkʃii	pəkʃapəkʃi
pəkʃii	pəkʃi
pəkhəvaɟə	pəkʰvaɟ
pəkhəvaɖikə	pəkʰvaɖik
pəkhaɭəvu~	pəkʰaɭvu~
pəgə	pəg
pəgəthiju~	pəgətʰiju~
pəgəpaɭu~	pəgpaɭu~
pəgəpesaro	pəgpesaro
pəgəbhərə	pəgbʰər
pəgərəkhu~	pəgərkʰu~
pəgərəvə	pəgrəv
pəgəlu~	pəglu~
pəgarə	pəgar
pəgi	pəgi
pəgeru~	pəgeru~
pəcərə~gii	pəcrə˜gi
pəcəvu~	pəcvu~
pəcasə	pəcas
pəcciisə	pəccis
pəchəɖaʈə	pəchɖaʈ
pəchaɖəvu~	pəcʰaɖvu~
pəchatə	pəcʰat
pəchii	pəcʰi
pəchiitə	pəcʰit
pəcheɖii	pəcʰeɖi
pəɟəvəɳii	pəɟəvɳi
pəɟəvəvu~	pəɟəvvu~
pəʈəko	pəʈko
pəʈəpəʈə	pəʈpəʈ
pəʈəlaii	pəʈlai
pəʈəlaɳii	pəʈlaɳi
pəʈabaɟə	pəʈabaɟ
pəʈabaɟii	pəʈabaɟi
pəʈaməɳii	pəʈamɳi
pəʈavəvu~	pəʈavvu~
pəʈavaɭo	pəʈavaɭo
	pəʈʈi
	pəʈel
	pəʈʈo
pəɖə	pəɖ
pəɖəkarə	pəɖkar
pəɖəkhu~	pəɖkʰu~
pəɖchajo	pəɖcʰajo
pəɖətərə	pəɖtər
pəɖətii	pəɖti
pəɖətu~	pəɖtu~
pəɖədo	pəɖdo
pəɖəpuuchə	pəɖpucʰ
pəɖəvu~	pəɖvu~
pəɖəvo	pəɖvo
pəɖavə	pəɖav
pəɖijo	pəɖijo
pəɖii	pəɖi
pəɖiikii	pəɖiki
pəɖiiku~	pəɖiku~
pəɳə	pəɳ
pəɳəchə	pəɳəcʰ
pəʈə	pət
pəʈənə	pətən
pətərii	pətri
pətəru~	pətru~
pətəvu~	pətvu~
pətə~gə	pətə˜gə
pətə~giju~	pətə˜giju~
pətakəɖu~	pətakɖu~
pətavəʈə	pətavəʈ
pətavəvu~	pətavvu~
pətasu~	pətasu~
pəti	pəti
pətiju~	pətiju~
pəttu~	pəttu~
	pətto
pətnii	pətni
pətrə	pətrə
pətrəkarə	pətrəkar
pətrika	pətrika
pəthəraɭə	pətʰraɭ
pəthərii	pətʰri
pəthəro	pətʰro
pətharii	pətʰari
pəththərə	pətʰtʰər
pədə	pəd
pədəvii	pədvi
pədarthə	pədartʰə
pədavəli	pədavli
pədavəvu~	pədavvu~
pədhdhəti	pədʰdʰəti
pədjə	pədjə
pədhəravəvu~	pədʰravvu~
pədharəvu~	pə0ʰarvu~
pəno	pəno
pənotii	pənoti
pənotu~	pənotu~
pəpəiju~	pəpəiju~
pərə	pər
pərəkiijə	pərkij
pərəkhə	pərəkʰ
pərəkhavəvu~	pərkʰavvu~
pərəgəɟu	pərgəɟu~
pərəgamə	pərgam
pərəcurəɳə	pərcurəɳ
pərəco	pərco
pərəɟiivii	pərɟivi
pərəɳəv~	pərəɳvu~
pərətə	pərət
pərətə~trə	pərtəntrə
pərədado	pərdado
pərəduŠkhə	pərdukʰ
pərədeʃə	predeʃ
pərədo	pərdo
pərədhənə	pərdʰən
pərədhərmə	pərdʰərma
pərəna,tiilu~	pərnatilu~
pərəpurus°ə	pərpuruʃ
pərəpoʈii	pərpoʈi
pərəpoʈo	pərpoʈo
pərəbə	pərəb
pərəbiiɖiiju~	pərbiɖiju~
pərəbhəvə	pərbʰəv
pərəmə	pərəm
pərəmaɳu~	pərmaɳu
pərəmatma	pərmatma
pərəmarthə	pərmartʰə
pərəmeʃvərə	pərmeʃvər
pərəlokə	pərlok
pərəvəɖəvu~	pərvəɖvu~
pərəvəʃə	pərvəʃ
pərəvəɭə	pərvə
pərəva	pərva
pərəvanəgii	pərvangi
pərəvano	pərvano
pərəsevo	pərsevo
pərəstrii	pərstri
pərəspərə	pərəspər
pərə~tu	pərəntu
pərə~pəra	pərəmpəra
pərəkas°ʈa	pərakaʃtʰa
pərakrəmə	pərakrəm
pərakrəmii	mI 
pərakrəmii	pərakrəmi
pəraɟəjə	pəraɟəj
pəraɳe	pəraɳe
pəradhiinə	pəradʰin
pəramərʃə	pəramərʃə
pəraju~	pəraju~
pəridhə	pərigʰ
pəricəjə	pəricəj
pəricarika	pəricarika
pəricitə	pəricit
pəricchedə	pəriccʰed
pəriɳamə	pəriɳam
pəriɳiitə	pəriɳit
pəridhanə	pəridʰan
pəripəkva	pəripəkvə
pəribəɭə	pəribə
pəribhas°a	pəribʰaʃa
pərimələ	pəriməl
pərivərtənə	pərivərtən
pərivarə	pərivar
pəriʃis°ʈə	pəriʃiʃʈʰə
pəriʃiilənə	pəriʃilən
pəriʃrəmə	pəriʃrəm
pəris°ədə	pəriʃəd
pəristhiti	pəriʃtʰiti
pərii	pəri
pəriikʃəkə	pərikʃək
pəriikʃəɳə	pərikʃəɳ
pərikʃa	pərikʃa
pəru	pəru
pəru~	pəru~
pəreʃanə	pəreʃan
pərokʃə	pərokʃə
pəroɖhə	pəroɖʰ
pəroɳo	pəroɳo
pəropəkarə	pəropkar
pəropəkarii	pəropkari
p]rovəvu~	pərovvu~
pərjaptə	pərijaptə
pərjus°əɳə	pərjuʃəɳ
	pələk
pələkaro	pəlkaro
pələʈəɳə	pəlʈəɳ
pələʈəvu~	pələʈvu~
pələʈo	pəlʈo
pələɭəvu~	pələɭvu~
pələ~gə	pələ˜g
pəla~ʈhii	pəla~ʈʰi
pəliitə	pəlit
pəloʈəvu~	pəloʈvu~
pəvənə	pəvən
pəvitrə	pəvitrə
pəʃu	pəʃu
pəʃcatapə	pəʃcatap
pəʃcimə	pəʃcim
pəsə~də	pəsənd
pəstavu~	pəstavu~
pəstii	pəsti
pəhaɖə	pəhaɖ
pəhaɳo	pəhaɳo
pəherəɳə	pəherəɳ
pəherəvu~	pəhervu~
pəherəveʃə	pəherveʃ
pəhero	pəhero
pəhelə	pəhel
pəheləvanə	pəhelvan
pəhelu~	pəhelu~
pəho~cə	pəha~c
pəha~cəvu~	pəha~cvu~
pəhoɭu~	pəhoɭu~
pəha~cii	pəha~ci
pəha~co	pəha~co
pəɭə	pəɭ
pə~kti	pə˜ki
pə~khii	pə˜kʰi
pə~kho	pə˜kʰo
pə~gətə	pə˜gət
pə~cə	pəµcə
pə~caɳu~	pəµcaɳu~
pə~catə	pəµcat
pə~camru≤tə	pəµcamrut
pə~cajətə	pəµcajət
pə~calə	pəµcal
pə~cavənə	pəµcavən
pə~caʃii	pəµcaʃi
pə~ca~gə	pəµca~˜gə
pə~coterə	pəµcoter
pə~ɟo	pəµɟo
pə~ɖə	pəɳɖə
pə~ɳitə	pəɳɖit
pə~thə	pəntʰ
pə~dərə	pəndər
pə~paɭəvu~	pəmpaɭvu~
pa	pa
pakə	pak
pakəvu~	pakvu~
pakəʃaʃtrə	pakʃaʃtrə
paku~	paku~
pakʃikə	pakʃik
pakhə~ɖə	pakʰəɳɖ
pakhə~ɖii	pakʰəɳɖi
pagələ	pagəl
paghəɖii	fem
pacənə	pacən
pachəlu~	pacʰlu~
pachəɭə	pacʰəɭ
pachu~	pacʰu~
paɟii	paɟi
paʈə	paʈ
paʈənəgərə	paʈnəgər
paʈəluunə	paʈlun
paʈiju~	paʈiju~
paʈidarə	paʈidar
paʈu	paʈu~
paʈhə	paʈʰ
paʈhəvəvu~	paʈəvvu~
paɖəvu~	paɖvu~
paɖii	paɖi
paɖu~	paɖu~
paɖo	paɖo
paɖoʃə	paɖoʃ
paɖoʃii	paɖoʃi
paɖoʃəɳə	paɖoʃəɳ
paɳijaru~	paɳijaru~
paɳii	paɳi
paɳiicu~	paɳicu~
paɳiidarə	paɳidar
patəɭu~	patɭu~
padərii	padri
panə	pan
panəkhərə	pankʰər
panii	pani
panu~	panu~
panetərə	panetər
papəɖə	papəɖ
papəɖii	papɖi
papii	papi
pamərə	pamər
paməvu~	pamvu~
pajəɟamo	pajɟamo
pajəmalə	pajmal
pajələ	pajəl
pajələ	pajo
parəku~	parku~
parəkhəvu~	parəkʰvu~
parəkhu~	parkʰu~
parəɳu~	parɳu~
parədərʃəkə	pardərʃək
parəghii	pargʰi
parəsii	parsi
parə~gətə	parəmgət
parajəɳə	parajəɳ
pariɟatə	pariɟat
paritos°ikə	paritoʃik
parevu~	parevu~
paləkə	palək
paləkhii	palkʰi
paləvəvu~	paləvvu~
palo	palo
pavətii	pavti
pavərədhu~	pavərdʰu~
pasu~	pasu~
pase	pase
paɭə	paɭ
paɭəvu~	paɭvu~
paɭijo	paɭijo
pa~khə	pa~kʰ
pa~khəɖii	pa~kʰɖi
pa~khu~	pa~kʰu~
pa~gərəvu~	pa~gərvu~
pa~cə	pa~c
pa~cəmə	pa~cəm
pa~ɟərapoɭə	pa~ɟrapoɭ
pa~ɟəru~	pa~ɟru~
pa~triisə	pa~tris
pa~thii	pa~tʰi
pa~dəɖii	pa~dɖi
pa~pəɳə	pa~pəɳ
pa~səʈhə	pa~səʈʰ
pa~səɭii	pa~səɭi
picəkarii	pickari
pita	pita
pittə	pittə
pittəɭə	pittəɭ
pitrəii	pitrai
pitəraii	pitərai
pipuuɖii	pipuɖi
pijərə	pijər
piju	piju
pillu~	pillu~
piʃacə	piʃac
pistaɭiisə	pistaɭis
pi~ɖii	piɳɖi
piigəɭəvu~	pigəɭvu~
piichu~	picʰu~
piichehəʈhə	picʰehəʈʰ
piicho	picʰo
piiʈəvu~	piʈvu~
piiʈhə	piʈʰ
piiʈhiika	piʈʰika
piiʈhii	piʈʰi
piiɖa	piɖa
piiɳu~	piɳu~
piipə	pip
piipəɭə	pipəɭ
piipəɭo	pipɭo
piirəsəvu~	pirəsvu~
piiləvu~	pilvu~
piilu~	pilu~
piivu~	pivu~
piisəvu~	pisvu~
piiɭaʃə	piɭaʃ
piiɭu~	piɭu~
pi~khəvu~	pi~kʰvu~
pi~ɟəvu~	pi~µɟvu~
pukhtə	pukʰtə
puɳjə	puɳjə
putrə	putrə
putrəvədhuu	putrəvədʰu
putrii	putri
punər	punər
i]a /punravrutti/ 	punravrutti
punərukti	punərukti
punərləgnə	punərləgnə
punitə	punit
purəbəharə	purbəhar
purəvəʈho	purvəʈʰo
purəvəɳii	purəvɳi
purəvarə	purvar
purəskərta	purəskərta
purəskarə	purəskar
puraɳə	puraɳ
puraɳu~	puraɳu~
puratənə	puratən
puravo	puravo
pura~tə	pura~nt
purus°ə	puruʃ
purohitə	purohit
pulavə	pulav
pus°kəɭə	puʃkə
pus°pə	puʃpə
pustəkə	pustək
pustika	pustika
pulli~gə	pulling
puuchəvu~	pucʰvu~
puuɟəvu~	puɟvu~
puuɟa	puɟa
puuɟapo	puɟapo
puuɟarəɳə	puɟarəɳ
puuɟarii	puɟari
puuɟjə	puɟjə
puuʈhə	puʈʰ
puutəɭii	putɭi
purəkə	purək
puurətu~	purtu~
puurəpaʈə	purpaʈ
puurəvu~	purvu~
puurii	puri
puuru~	puru~
puurepuru~	purepuru~
puurɳə	purɳə
puurɳa~kə	purɳa~k
puurɳima	purɳima
puurvə	purvə
puurvəgrəhə	purvəgrəhə
puurvəɟə	purvəɟ
puurvəpəkʃə	purvəpəkʃə
puurvapərə	purvapər
puuɭo	puɭo
puu~chəɖu~	pu~cʰɖu~
puu~ɟii	pu~ɟi
puu~ɟo	pu~ɟo
(9kr8 /prutʰəkkərəɳ/ 	prutʰəkkərəɳ
pr≤uthəvii	prutʰvi
peʈə	peʈ
peʈəbhəru~	peʈbʰəru~`
peʈavəvu~	peʈavvu~
peʈii	peʈi
peɖhii	peɖʰi
peɖhu~	peɖʰu~
peɳii	p´ɳi
pelu~	pelu~
peʃabə	peʃab
pesəvu~	pesvu~
pe~ɖo	peɳɖo
pe~təro	p´~tro
pəiɖu~	pəiɖu~
pəisadarə	pəisadar
pəiso	pəiso
pokə	pok
pokəɭə	pokəɭ
pokarə	pokar
pochu~	pocu~
poʈəlii	poʈli
poʈhə	poʈʰ
poɖhəvu~	poɖʰvu~
poɳu~	poɳu~
poɳoso	poɳoso
potə	pot
potu~	potu~
pote	pote
pothii	potʰi
podəɭo	podɭo
popəcu~	popcu~
popəʈə	popəʈ
popəɖo	popɖo
pojəɳu~	pojɳu~
poladə	polad
polu~	polu~
poʃakə	poʃak
pos°ə	poʃ
pos°əkə	poʃək
pos°əɳə	poʃəɳ
poɭə	poɭ
po~kə	pø~k
po~khəvu~	pø~kʰvu~
pəutrə	pəutrə
pəutrii	pəutri
pəuraɳikə	pəuraɳik
pəus°ʈikə	pəuʃʈik
pəua	pəua
prəkəʈə	prəkəʈ
prəkərəɳə	prəkrəɳ
prəkarə	prəkar
prəkaʃə	prəkaʃ
prəkaʃəvu~	prəkaʃvu~
prəkr≤uti	prəkruti
prəkopə	prəkop
prəkriija	prəkrija
prəkhjatə	prəkʰjat
prəgəʈəvu~	prəgəʈvu~
prəgəti	prəgəti
prəcəlitə	prəcəlit
prəcə~ɖə	prəcəɳɖə
prəcarə	prəcar
prəcurə	prəcur
prəchənnə	prəcʰənn
prəɟənənə	prəɟənən
prəɟəɭəvu~	prəɟəɭvu~
prəɟa	prəɟa
prəɳamə	prəɳam
prəɳamii	prəɳali
prəɳaliika	prəɳalika
prəɳeta	prəɳeta
prətə	prət
prəti	prəti
prətikərə	prətikar
prətikavjə	prətikavjə
prətikuuɭə	prətikuɭ
prətikrija	itik
prətikrija	prətikrija
prətighos°ə	prətigʰoʃ
prətigna	prətigna
prətidhvni	prətidʰvəni
prətinidhi	prətinidʰi
prətipəkʃə	prətipəkʃə
prətibə~dhə	prətibəndʰə
prətibi~bə	prətibimbə
prətibha	prətibʰa
prətirodhə	prətirodʰ
prətivadə	prətivad
prətis°ʈha	prətiʃʈʰa
prətə	t 
prətiharə	prətihar
prətiikə	prətik
prətiikʃa	prətikʃa
prətiiti	prətiti
prətjəkʃə	prətjəkʃə
prətjəjə	prətjəjə
prətjə~ca	prətjənca
prətje	prətje
prətjekə	prətjek
prəthəmə	prətʰəm
prəthəma	prətʰəma
	prətʰa
prədəkʃiɳa	prədəkʃiɳa
prədərʃəkə	prədərʃək
prədərʃənə	prədərʃən
prədanə	prədan
prədeʃə	prədeʃ
prədos°ə	prədoʃ
prədhanə	prədʰn
prəpə~cə	prəpəµc
prəbəɭə	prəbəɭ
prəbhatə	prəbʰat
prəbhatiju~	prəbʰatiju~
prəbhavə	prəbʰav
prəbhu	prəbʰu
prəbhuttvə	prəbʰutvə
prəməttə	prəməttə
prəmaɳə	prəmaɳ
prəthəmə	9m 
prəmaɳikə	prəmaɳik
prəmadə	prəmad
prəmukhə	prəmukʰ
prəmejə	prəmejə
prəjətnə	prəjətnə
prəjaɳə	prəjaɳ
prəjasə	prəjas
prəjogə	prəjog
prəjoɟəkə	prəjoɟək
prələjə	prələj
prəlapə	prəlap
prəlobhənə	prəlobʰən
prəvəcənə	prəvəcən
prəvahə	prevah
prəvahii	prəvahi
prəviiɳə	prəviɳ
prəvr≤utti	prəvrutti
prəveʃə	prəveʃ
prəveʃəkə	prəveʃək
prəveʃika	prəveʃika
prəʃəsti	prəʃəsti
prəsə~ʃəkə	prəʃəmʃək
prəsə~ʃa	prəʃəmʃa
prəʃnə	prəʃnə
prəʃnəpətrə	prəʃnəpətrə
prəsənnə	prəsənnə
prəsərəvu~	prəsərvu~
prəsə~gə	prəsə˜g
prəsadə	prəsad
prəsadii	prəsadi
prəsadhənə	prəsadʰən
prəsarə	prəsar
prəsidhdhə	prəsidʰdʰə
prəstavə	prəstav
prəsthanə	prəstʰan
prəhəsənə	prəhəsən
prəharə	prəhar
praciinə	pracin
praɳə	prəɳ
praɳii	praɳi
prathəmikə	pratʰmik
pradeʃikə	pradeʃik
pradhanjə	pradʰanjə
pradhjapəkə	pradʰjapək
prajəʃcitə	prajəʃcit
prajogikə	prajogik
prarəbdhə	prarəbdʰə
prasə	pras
prasə~gikə	prasəmgik
pra~tə	prant
prijə	prijə
priitə	prit
prekʃəkə	prekʃək
pretə	pret
premə	prem
prerəkə	prerək
prerəɳa	prerəɳa
prerəvu~	prervu~
protsahənə	protsahən
prəuɖhə	prəuɖʰ
phəkəro	pʰəkro
phəkiirə	pʰəkir
phəkiirii	pʰəkiri
phəktə	pʰəktə
phəgavəvu~	pʰəgavvu~
phəɟetii	pʰəɟeti
phəʈə	pʰəʈ
phəʈəkəɖii	pʰəʈəkɖi
phəʈəkəvu~	pʰəʈəkvu~
phəʈəkavəvu~	pʰəʈkarvu~
phəʈəkiiju~	pʰəʈək(i)ju~
phəʈəko	pʰəʈko
phəʈəkəɖo	pʰəʈakɖo
phəʈəɳu~	pʰəʈaɳu~
phəɖəkə	pʰəɖək
phəɖəko	pʰəɖko
phəɖəco	pʰəɖco
pəʈaphəʈə	pʰəʈapʰəʈ
phəɳəko	pʰəɳgo
phətehə	pʰəteh
phəphəɭətu~	pʰəpʰəɭtu~
phərəkə	pʰərək
phərəkəvu~	pʰərəkvu~
phərəɟə	pʰərəɟ
phərəɟijatə	pʰərɟijat
phərəɟijatə	 <phərəɟijatə>  adj  
phərətaramə	pʰərtaram
phərətaramə	 <phərətaramə>  
phərətu~	pʰərtu~
phərəmanə	pʰərman
phərəvu~	pʰərvu~
phərəsaɳə	pʰərsaɳ
phərakə	pʰərak
phəraɭə	pʰəraɭ
phərijadə	pʰərijad
phərijadii	pʰərijadi
phərii	pʰəri
phəlaɳu~	pʰəlaɳu~
phəlaharə	pʰəlahar
phəsəkəvu~	pʰəsəkvu~
phəsavu~	pʰəsavu~
phəɭə	pʰəɭ
phəɭədajəkə	pʰəɭdajək
phəɭəvu~	pʰəɭvu~
phəɭau~	pʰəɭau~
phəɭiju~	pʰəɭiju~
phə~goɭəvu~	pʰə˜goɭvu~
phə~ʈavu~	pʰəɳʈavu~
phə~ɖə	pʰənɖ
phə~phosəvu~	pʰəmpʰosvu~
phə~phosəvu~	 <phə~phosəvu~>  
phakəvu~	pʰəkvu~
phakii	pʰaki
phako	pʰako
phagəɳə	pʰagəɳ
phacərə	pʰacər
phaɟələ	pʰaɟəl
phaʈə	pʰaʈ
phaʈəkə	pʰaʈək
phaʈəphuʈə	pʰaʈpʰuʈ
phaʈəvu~	pʰaʈvu~
phaɖə	pʰaɖ
phatəɖo	pʰatɖo
phanəsə	pʰanəs
phajədo	pʰajdo
pharəgətii	pʰargəti
pharəsə	pʰarəs
phalə	pʰal
phalətu~	pʰaltu~
phaləvu~	pʰalvu~
phvəʈə	pʰavəʈ
phavəvu~	pʰavvu~
phaɭəvəɳii	pʰaɭəvɳi
phaɭiju~	pʰaɭiju~
phaɭo	pʰaɭo
pha~kəɖu~	pʰa~kɖu~
pha~ko	pʰa~ko
pha~ʈo	pʰa~ʈo
pha~də	pʰa
pha~pha~	pʰa~pʰa~
pha~sə	pʰa~s
pha~sii	pʰa~si
pha~siigərə	pʰa~sigər
	pʰa~so
phikərə	pʰikər
phikku~	pʰikku~
phiʈəkarə	pʰiʈkar
philəsuuphə	pʰilsupʰ
philəsuuphii	pʰilsupʰi
phiiɳə	pʰiɳ
phiiɳəvu~	pʰiɳvu~
phiiphu~	pʰipʰu~
phuugavo	pʰugavo
phutkarəvu~	pʰutkarvu~
phudiino	pʰudino
phuurəsədə	pʰursəd
phuuleku~	pʰuleku~
phuuvaro	pʰuvaro
	 <
phuugə	pʰug
phuugəvu~	pʰugvu~
phuuʈəvu~	pʰutvu~
phuudu~	pʰudu~
phuumətu~	pʰumtu~
phuulə	pʰul
phuuləɳəɟii	pʰuləɳɟi
phuuləvəvu~	pʰuləvvu~
phuuləvu~	pʰulvu~
phuu~kə	pʰu~k
phuu~kəvu~	pʰu~kvu~
phephəsu~	pʰepʰsu~
pherə	pʰer
pheriijo	pʰerijo
pherii	pʰeri
phero	pʰero
phelavu~	pʰelavu~
phelavo	pʰelavo
phe~kəvu~	pʰ´~kvu~
phe~ʈo	pʰ´~ʈo
phe~dəvu~	pʰ´~dvu~
phe~səlo	pʰ´~slo
phoii	pʰoi
phokə	pʰok
phoɟə	pʰoɟ
phoɖəvu~	pʰoɖvu~
photərii	pʰotri
phoru~	pʰoru~
pholəvu~	pʰolvu~
phollii	pʰolli
phosəlavəvu~	pʰoslavvu~
bəkəbəkə	bək bək
bəkərii	bəkri
bəkəru~	bəkru~
bəkəro	bəkro
bəkəvu~	bəkvu~
bəkʃisə	bəkʃiʃ
bəkhətərə	bəkʰtər
bəkhijo	bəkʰijo
bəkheɖo	bəkʰeɖo
bəkholə	bəkʰol
bəgəɖəvu~	bəgəɖvu~
bəgəɖo	bəgɖo
bəgələ	bəgəl
bəgaɖə	bəgaɖ
bəgaɖəvu~	bəgaɖvu~
bəgaɖəvu~	bəgasu~
bəgico	bəgico
bəcəku~	bəcku~
bəcətə	bəcət
bəcəpəɳə	bəcpəɳ
bəcəvu~	bəcvu~
bəcavə	bəcav
bəccu~	bəccu~
bəɟarə	bəɟar
bəɟhaɖəvu~	bəɟʰaɖvu~
bəʈako	bəʈako
bəɖəbəɖəvu~	bəɖbəɖvu~
bəɖaii	bəɖai
bəɖaʃə	bəɖaʃ
bəɳəgu~	bəɳgu~
	bətək
bətavəvu~	bətavvu~
bəttii	bətti
bətriisə	bətris
bədənə	bədən
bədənəkʃii	bədnəkʃi
bədənamə	bədnam
bədəbu	bədbu
bədəmaʃə	bədmaʃ
bədəlo	bədlo
bədəsuurətə	bədsurət
bədamə	bədam
bədii	bədi
bədhu~	bədʰu~
bənəvu~	bənvu~
bənavə	bənav
bənavəʈə	bənavəʈ
bənevii	bənevi
bənne	bənne
bəporə	bəpor
bəpharo	bəpʰaro
bəbuucəkə	bəbucək
bəməɳu~	bəmɳu~
bəjanə	bəjan
bərəkətə	bərkət
bərəchəʈə	bərcʰəʈ
bərəchəʈə	 <bərəchəʈə> adj  
bərəɖo	bərɖo
bərəɳii	bərɳi
bərəphə	bərəpʰ
bərəphii	bərpʰi
bərəbadə	bərbad
bərabərə	bərabər
bərabərə	 <bərabərə>  adj  1 
bərobərə	bərobər
bəroɭə	bəroɭ
	bəlke
bəla	bəla
bəli	bəli
bəsə	bəs
bəhaduurə	bəhadur
bəhanu~	bəhanu~
bəharə	bəhar
bəhis°karə	bəhiʃkar
bəhu~	bəhu~
bəhucəra	bəhucəra
bəhuməti	bəhuməti
bəhuuruupii	bəhurupi
bəhu~vəcənə	bəhu~vəcən
bəhenə	bəhen
bəhenə	bəheru~
bəheraʃə	bəheraʃ
bəɭə	bəɭ
bəɭətəɳə	bəɭtəɳ
bəɭətəra	bəətəra
bəɭədə	bəɭəd
bəɭəvakhorə	bəɭvakʰor
bəɭəvu~	bəɭvu~
bəɭəvo	bəɭvo
bəɭatkarə	bəɭatkar
bəɭija	bəɭija
bəɭiju~	bəɭiju~
bəɭevə	bəɭev
bə~gəɖii	bə˜gɖi
bə~ɖii	bə˜ɖi
bə~dərə	bəndər
bə~dukə	bənduk
bə~dukəɖii	bəndukɖi
bə~dobəstə	bəndobəstə
bə~dhə	bəndʰə
bə~dhənə	bəndʰən
bə~dharəɳə	bəndʰarəɳ
bə~dhijarə	bəndʰijar
bə~dhii	bəndʰi
bə~dhu	bəndʰu
bə~bavaɭo	bəmbavaɭo
bə~bo	bəmbo
bə~sərii	bənsri
ba	ba
baii	bai
bakii	baki
bakhəɖəvu~	bakʰəɖvu~
bagə	bag
baghu~	bagʰu~
baɟə	baɟ
baɟəʈhə	baɟəʈʰ
baɟərii	baɟri
baɟii	baɟi
baɟiigərə	baɟigər
baɟhəvu~	baɟʰvu~
baʈəlii	baʈli
baɳə	baɳ
baɳavəɭii	baɳavəɭi
batələ	batəl
bapə	bap
bapəɖu~	bapɖu~
bapədada	bapdada
baphəvu~	bapʰvu~
babətə	babət
babagaɖii	babagaɖi
babo	babo
barə	bar
barəɳu~	barɳu~
barəmu~	barmu~
baɭəpothii	baldi
baɭəpothii	baɭpotʰi
baɭəbodhə	baɭbodʰ
baɭəmə~dirə	baɭməndir
baɭələgnə	baɭləgnə
baɭəvu~	baɭvu~
ba~kəɖo	ba~kɖo
ba~dhəvu~	ba~dʰvu~
ba~dho	ba~dʰo
ba~jə	ba~j
ba~jədhərii	ba~jdʰəri
bicaru~	bicaru~
bichanu~	bicʰanu~
biichavəvu~	bicʰavvu~
binəɟəruurii	binɟəruri
binəʃərətii	binʃərti
biləkulə	bilkul
bilaɖii	bilaɖi
bilaɖo	bilaɖo
billo	billo
bivəɖavəvu~	bivɖavvu~
bihaməɳu~	bihaməɳu~
bi~dii	bindi
bi~du	bindu
bi~bə	bimb
bii	bi
biikə	bik
biiɟə	biɟ
biiɟəvərə	biɟvər
biiɟu~	biɟu~
biiɖəvu~	biɖvu~
biiɖii	biɖi
biina	bina
biibii	bibi
biibu~	bibu~
bibhətsə	bibʰətsə
bimarə	bimar
bimarii	bimari
biivu~	bivu~
buʈhʈhu~	buʈʰʈʰu~
buɖəthələ	buŒtʰəl
buɖəvu~	buɖvu~
budhdhi	budʰdʰi
budhəvarə	budʰvar
buməraɳə	bumraɳ
buməraɳə	 <buməraɳə>  fem  
burəkho	burkʰo
buləbulə	bulbul
bulə~də	bulənd
bu~də	bund
buu	bu:
buucə	buc
buucu~	bucu~
buuʈə	buʈ
buumə	bum
buuməlu~	bumlu~
be	be
beabəruu	beabru
beiimanə	beiman
beu~	beu
bekii	beki
bekhəbərə	bekʰəbər
begəmə	begəm
becenə	becen
becenii	beceni
beʈə	beʈ
beʈii	beʈi
beʈo	beʈo
beʈhəkə	beʈʰək
beʈhaɖu~	beʈʰaɖu~
beɖii	beɖi
beɖii	 <beɖii>  fem  shackles 
beɖu~	beɖu~
beɖoɭə	beɖoɭ
beɖhə~gu~	beɖʰə˜gu~
betaɭa~	betaɭa~
betaɭiisə	betaɭis
bedərəkarə	bedərkar
bedhəɖəkə	bedʰəɖək
bedhəɖəkə	 <bedhəɖəkə>  
bədharu~	bedʰaru~
bedhjnə	bedʰjan
benəmuunə	benmun
bepəgu~	bepəgu~
bepəgu~	 <bepəgu~>  adj  biped 
bebakəɭu~	bebakɭu~
bebhanə	bebʰan
bebhanə	 <bebhanə>  adj  
beroɟəgarə	beroɟgar
beləɖii	belɖi
beləɖii	 <beləɖii>  adj  a pair (of 
bevəkuphə	bevkupʰ
bevəɖə	bevəɖ
beʃəkə	beʃək
beʃərəmə	beʃərəm
beʃərəmə	 <beʃərəmə>  adj  
beʃudhdhə	beʃuddʰ
beʃumarə	beʃumar
beʃumarə	 <beʃumarə>  adj  
besəɳu~	besɳu~
besəvu~	besvu~
besvadə	besvad
behalə	behal
behuudii	behudi
bəirii	bəiri
bokhu~	bokʰu~
bogədu~	bogdu~
bocii	boci
boɟə	boɟ
boɖəvu~	boɖvu~
boɖu~	boɖu~
boɳii	boɳi
bodu~	bodu~
bodhə	bodʰ
borə	bor
bolə	bol
boləvu~	bolvu~
bolacalii	bolacali
bolii	boli
bovu~	bovu~
boɭəvu~	boɭvu~
bjaʃii	bjaʃi
brahməɳə	brahməɳ
bhəktə	bʰəktə
bhəktaɳii	bʰəktaɳi
bhəkti	bʰəkti
bhəgətə	bʰəgət
bhəgətaɳii	bʰəgtaɳi
bhəgəvətii	bgvəti
bhəgəvanə	b+əgvan
bhəgəvu~	bʰəgvu~
bhəginii	bgini
bhədiirəthə	bgirətʰ
bhəgnə	bʰəgnə
bhəcəɖəvu~	bʰəcəɖvu~
bəɟənə	bʰəɟən
bhəɟəvəvu~	bʰəɟəvvu~
bhəɟəvu~	bʰəɟvu~
bpəjiyu~	bʰəɟiju~
bhəɟiju~	bʰəʈəkvu~
bhəʈəkavu~	bʰəʈkavu~
bhəʈuuriju~	bʰəturiju~
bhəttə	bhəʈʈə
bhəʈhʈhii	bʰəʈʰʈʰi
bhəʈhʈhii	 <bhəʈhʈhii>  fem  1 an 
bhəɖə	bʰəɖ
bhəɖəviirə	bʰəɖvir
bhəɖəkii	bʰəɖki
bhəɖəko	bʰɖko
bhəɖako	bʰəɖako
bhəɳəkarə	bʰəɳkar
bhəɳətərə	bʰəɳtər
bhəɳəvu~	bʰəɳvu~
bhətriiɟii	bʰətriɟi
bhədrə	bʰədrə
bhəpəko	bʰəpko
bhəbhəkə	bʰəbʰək
bhəbhuukəvu~	bʰəbʰukvu~
bhəbhuutə	bʰəbʰut
bhəbhuutii	bʰəbʰuti
bhəmərii	bʰəmri
bhəməro	bʰəmro
bhəməvu~	bʰəmvu~
bhəmmərə	bʰəmmər
bhəjə~kərə	bʰəjankər
bhəjə~kərə	 <bhəjə~kərə>  adj  
bhəjanəkə	bʰəjanək
bhəjanəkə	 <bhəjanəkə>  
bhərəɖəvu~	bʰərəɖvu~
bhərətə	bʰərət
bhərətii	bʰərti
bhərəpuurə	bʰərpur
bhərəmə	bʰərəm
bhərəmavu~	bʰərmavu~
bhərəvəvu~	bʰərəvvu~
bhərəvaɖə	bʰərvaɖ
bhərəvaɖə	 <bhərəvaɖə>  masc  
bhərəvu~	bʰərvu~
bhərau	bʰərau
bhəroso	bʰəroso
bhəroso	 <bhəroso>  masc  
bhəlaii	bʰəlai
bhəlaməɳə	bʰəlaməɳ
bhəlu~	bʰəlu~
bhəle	bʰəle
bhəvə	bʰəv
bhəvənə	bʰəvən
bhəvaii	bʰəvai
bhəvaɖo	bʰəvaɖo
bhəvanii	bʰəvani
bhəvajo	bʰəvajo
bhəvis°jə	bʰəviʃjə
bhəvu~	bʰəvu~
bhəvobhəvə	bʰəvobʰəv
bhəvjə	bʰəvjə
bhəsəvu~	bʰəsvu~
bhəɭətu~	bʰəɭtu~
bhəɭəvu~	bʰəɭvu~
bhə~gaɳə	bʰə˜gaɳ
bhə~garə	bʰə˜gar
bhə~ɖarə	bʰəɳɖar
bhə~ɖaro	bʰəɳɖaro
bhə~ɖaro	bʰəɳɖo
bhə~bherəvu~	bʰəmbʰervu~
bha	bʰa
bhaii	bʰai
bhaiicaro	bʰaicaro
bhaiibə~dhii	bʰaibəndi
bhaiibha~ɖu	bʰaibʰa~ɳɖu
bhakhərii	bʰakʰri
bhagə	bʰag
bhagəvu~	bʰagvu~
bhagakarə	bʰagakar
bhagiidarə	bʰagidar
bhagiidarii	bʰagidari
bhagoɭə	bʰagoɭ
bhagjə	bʰagjə
bhagju~tuʈju~	bʰagju~tuʈju~
bhagje	əbʰagje
bhaɟii	bʰaɟi
bhaɟiimuuɭa	bʰaɟimuɭa
bhaʈə	bʰaʈ
bhaʈaii	bʰaʈai
bhaʈijo	bʰaʈijo
bhaɖu~	bʰaɖu~
bhaɖutə	bʰaɖut
bhaɳijo	bʰaɳijo
bhaɳii	bʰaɳi
bhaɳu~	bʰaɳu~
bhaɳeɟə	bʰaɳeɟ
bhaɳo	bʰaɳo
bhatə	bʰat
badərəvo	bʰadərvo
bhanə	bʰan
bhabhii	bʰabʰi
bharə	bʰar
bharəɳə	bʰarəɳ
bharətə	bʰarət
bharətiijə	bʰartijə
bhare	bʰare
bharo	bʰaro
bhaloɖu~	bʰaloɖu~
bhavə	bʰav
bhavəna	bʰavna
bhavəvu~	bʰavvu~
bhavarthə	bʰavartʰə
	bʰavi
bhavikə	bʰavik
bhas°əɳə	bʰaʃəɳ
bhas°a	bʰaʃa
bhas°a~tərə	bʰaʃa~ntər
bhas°jə	bʰaʃjə
bhasə	bʰas
bhaɭə	bʰaɭ
bhaɭəvu~	bʰaɭvu~
bha~gə	bʰa~˜gə
bha~gəphoɖə	bʰa~gpʰoɖ
bha~gəro	bʰa~˜gro
bha~gəvu~	bʰa~gvu~
bha~ɟəgəɖə	bʰa~ɟgəɖ
bha~ɖəvu~	bʰa~ɳɖvu~
bha~bhərəvu~	bʰa~bʰərvu~
bhikharəɳə	bʰikʰarəɳ
bhikharii	bʰikʰari
bhinnə	bʰinnə
bhiikhə	bʰikʰ
bhiiɖə	bʰiɖ
bhiiɖəvu~	bʰiɖvu~
bhiitərə	bʰitər
bhiinaʃə	bʰinaʃ
bhiinu~	bʰinu~
bhiilə	bʰil
bhii~gəɖu~	bʰi~gɖu~
bhiiɟəvəvu~	bʰi~ɟəvvu~
bhiɖo	bʰiɳɖo
bhi~tə	bʰi~t
bhuusko	bʰusko
bhuukə~pə	bʰukəmp
bhuukii	bʰuki
bhuuko	bʰuko
bhuukhə	bʰukʰ
bhuukhəru~	bʰukʰru
bhuukhju~	bʰukʰju~
bhugoɭə	bʰugoɭ
bhucərə	bʰucər
bhuutə	bʰut
bhuutavəɭə	bʰutavəɭ
bhuudevə	bʰudev
bhuumi	bʰumi
bhuumika	bʰumika
bhuumiti	bʰumiti
bhuumidahə	bʰumidah
bhuurəkii	bʰurki
bhuuriju~	bʰuriju~
bhuuru~	bʰuru~
bhuulə	bʰul
bhuuləvu~	bʰulvu~
bhuulu~	bʰulu~
bhuuvo	bʰuvo
bhu~kəvu~	bʰu~kvu~
bhu~gəɭə	bʰu˜gə
bhu~gəɭii	bʰu~˜gəɭi
bhu~gəɭu~	bʰu~˜gəɭu~
bhu~ɟəvu~	bʰu~ɟvu~
bhuu~ɖə	bʰuɳɖ
bbhuu~ɖaii	bʰuɳɖai
bhuuɖu~	bʰuɳɖu~
bhuu~səvu~	bʰu~svu~
bhegə	bʰeg
bhegə	bʰegu~
bheɟə	bʰeɟ
bheɟu~	bʰeɟu~
bheʈə	bʰeʈ
bheʈəvu~	bʰeʈvu~
bheʈo	bʰeʈo
bhedə	bʰed
bhedəbhavə	bʰedbʰav
bhedəvu~	bʰedvu~
bhedii	bʰedi
bhedu	bʰedu
bherəvəvu~	bʰerəvvu~
bheɭə	bʰeɭ
bheɭəvəvu~	bʰeɭəvvu~
bheɭəseɭə	bʰeɭseɭ
bheɭəseɭiiju~	bʰeɭseɭiju~
bhe~ʃə ~ bhe~sə	bʰ´~s ~ bʰ´~ʃ
bhoii	bʰoi
bhogə	bʰog
bhogəvəʈo	bʰogvəʈo
bhogəvəvu~	bʰogəvvu~
bhogvilaəs	bʰogvilas
bhogii	bʰogi
bhogjə	bʰogjə
bhoɟənə	bʰoɟən
bhoʈə	bʰoʈ
bhoʈəvo	bʰoʈvo
bhomijo	bʰomijo
bhori~gə	bʰori˜g
bholu~	bʰolu~
bhoɭəvəvu~	bʰoɭəvvu~
bhoɭu~	bʰoɭu~
bhokəvu~	bʰø~kvu~
bhoʈhəpə	bʰø~ʈʰəp
bhoʈhu~	bʰø~ʈʰu~
bhoə	bʰø~j
bhojətəɭiju~	bʰø~jtəɭiju~
bhojəru~	bʰø~jru~
bhəugolikə	bʰəugolik
bhətikə	bʰəutik
bhrəmə	bʰrəm
bhrəs°ʈə	bʰrəʃʈə
bhrəs°ʈacarə	bʰrəʃʈacar
bhraməkə	bʰramək
bra~ti	bʰra~nti
br≤uɳə	bʰruɳ
məkərə	məkər raʃi
məkaii	məkai
məkanə	məkan
məkkəmə	məkkəm
məkhəmələ	məkʰməl
məgə	məg
məgəɟə	məgəɟ
məgətəru~	məgətru~
məgəphəɭii	məgpʰəɭi
məgərə	məgər
məcəkə	məcək
məcəkoɖə	məckoɖ
məcəɖəvu~	məcəɖvu~
məcchərə	məccʰər
məchəvo	məcʰvo
məɟənuu	məɟnu
məɟəbuutə	məɟbut
məɟəbuutii	məɟbuti
məɟəbuurə	məɟbur
məɟəbuurii	məɟburi
məɟa	məɟa
məɟuurə	məɟur
məɟuusə	məɟus
məɟɟa	məɟɟa
məʈəku~	məʈku~
məʈəvu~	məʈvu~
məʈhə	məʈʰ
məʈharəvu~	məʈʰarvu~
məʈho	məʈʰo
məɖədu~	məɖdu~
məɖaga~ʈhə	məɖaga~ʈʰ
məɖhəvu~	məɖʰvu~
məɳi	məɳi
məɳijarə	məɳijar
mətə	mət
mətədarə	mətdar
mətəpətrə	mətpətrə
mətəbhedə	mətbʰed
mətələbə	mətləb
mətələbiju~	mətləbiju~
məti	məti
mətu~	mətu~
məthəvu~	mətʰvu~
məthaməɳə	mətʰaməɳ
məthaɭu~	mətʰaɭu~
mədədə	mədəd
mədəniju~	mədəniju~
mədarii	mədari
mədira	mədira
mədhə	mədʰ
mədhurə	mədʰur
mədhjə	mədʰjə
mədhəratə	mədʰrat
mənə	mən
mənənə	mənən
mənəsubo	mənsubo
mənəsvii	mənəsvi
mənaii	mənai
mənaməɳu~	mənamɳu~
mənavəvu~	mənavvu~
məniis°a	məniʃa
mənus°jə	mənuʃjə
məne	məne
mənobəɭə	mənobəɭ
mənorəthə	mənorətʰ
mənohərə	mənohər
məphətə	məpʰət
məbələkhə	məbləkʰ
məmətə	məmət
məməra	məmro
mərəkəvu~	mərəkvu~
mərəghii	mərgʰi
mərəɟadə	mərɟad
mərəɟadii	mərɟadi
mərəɟijatə	mərɟijat
mərəɟii	mərɟi
mərəɟiivo	mərɟivo
mərəɖavu~	mərɖavu~
mərəɖo	mərɖo
mərəɳə	mərəɳ
mərəɳiju~	mərəɳiju~
mərədə	mərəd
mərəvu~	mərvu~
mərəvo	mərvo
mərəsijo	mərəsijo
mərəhuumə	mərhum
məramətə	məramət
mərii	məri
məroɖə	məroɖ
mərmə	mərmə
mərjada	mərjada
mərjaditə	mərjadit
mələkəvu~	mələkvu~
mələmə	mələm
mələmələ	məlməl
məlaii	məlai
məvalii	məvali
məʃəru~	məʃru
məʃəhuurə	məʃhur
məʃkərii	məʃkəri
məsələtə	məslət
məsəɭəvu~	məsəɭvu~
məsaɳə	məsaɳ
məsaɳija	məsaɳijo
məsalo	məsalo
məso	məso
məstəkə	məstək
məhərs°i	məhərʃi
məhə~tə	məhənt
məha	məha
məhakavjə	məhakavjə
məhamarii	məhamari
məharəthii	məharətʰi
məharaɟə	məharaɟ
məharaɟa	məharaɟa
məharaɳii	məharani
məhaləjə	məhaləj
məhavəro	məhavro
məhino	məhino
məhila	məhila
məhuuvərə	məhuvər
məhe~kə	məh´~k
məheccha	məheccʰa
məheɳu~	məheɳu~
məhetələ	məhetəl
məhetii	məheti
məheto	məheto
məhenətə	məhenət
məhemanə	məheman
məhelə	məhel
məɭətərə	məɭtər
məɭəvu~	məɭvu~
mə~koɖo	mə˜koɖo
mə~gəɭəvarə	mə˜gəɭvar
mə~ɟiira	məµɟira
mə~ɟuurə	məµɟur
mə~,ɟuurii	məµɟuri
mə~ɖəpə	məɳɖəp
mə~ɖəvu~	məɳɖvu~
mə~tərəvu~	məntərvu~
mə~təvjə	məntəvjə
mə~trə	məntrə
mə~trii	məntri
mə~thənə	məntʰən
mə~də	mənd
mə~dəvaɖə	məndvaɖ
mə~dirə	məndir
mə~dii	məndi
ma	ma
maiika~gəlu~	maika˜glu~
m	makəɖ
makhə	makʰ
makhəɳə	makʰəɳ
magə	mag
magəvu~	magvu~
magu~	magu~
machəɳə	macʰəɳ
m	macʰli
	macʰi
maɟii	maɟi
maʈii	maʈi
maʈe	maʈe
maʈhu~	maʈʰu~
maɖii	maɖi
maɳə	maɳ
maɳəvu~	maɳvu~
maɳəsə	maɳəs
maɳəsaii	maɳsai
maɳekə	maɳek
mata	mata
matrə	matrə
matra	matra
mathakuuʈə	matʰakuʈ
mathabhare	matʰabʰare
mathu~	matʰu~
madəɭiju~	madəɭju
mada	mada
madhjəmə	madʰjəm
manə	man
manəta	manta
manədə	manəd
manəniijə	manənijə
manəpanə	manpan
manəvu~	manvu~
manəsikə	mansik
maniitu~	manitu~
manjə	manjə
mapə	map
maphii	mapʰi
mabapə	mabap
mama	mama
mamii	mami
mamuulii	mamuli
mamo	mamo
majəka~gəlu~	majka˜glu~
maja	maja
marə	mar
marəpiiʈə	marpiʈ
marəphətə	marpʰət
marəvu~	marvu~
maramarii	maramari
margə	marg
marmikə	marmik
malə	mal
malədarə	maldar
maləməta	malməta
malikə	malik
malikii	maliki
maliʃə	maliʃ
mavəɟətə	mavɟət
mavəʈhu~	mavʈʰu~
mavəɖiju~	mavəɖju~
mavətərə	mavtər
mavo	mavo
maʃii	maʃi
masə	mas
masikə	masik
maso	maso
mahitii	mahiti
maɭə	maɭ
maɭəkhu~	maɭkʰu~
maɭa	maɭa
maɭiju~	maɭiju~
maɭii	maɭi
maɭo	maɭo
ma~ɟəvu~	ma~ɟvu~
ma~ɖəvu~	ma~ɖvu~
ma~dəgii	ma~dgi
ma~dəlu~	ma~dlu~
ma~du~	ma~du~
ma~sə	ma~s
ma~saharə	ma~sahar
ma~saharii	ma~sahari
miɟagəru~	miɟagəru~
miɟaɟə	miɟaɟ
miɟaɟii	miɟaɟi
miti	miti
mitrə	mitrə
mitrəta	mitrəta
mithja	mitʰja
milkətə	milkət
milənə	milan
milavəʈə	milavəʈ
milavəvu~	milavvu~
mistrii	mistri
miʈhaii	miʈʰai
miiʈhaʃə	miʈʰaʃ
miiʈhu~	miʈʰu~
miiɳə	mi::ɳ
miiɳəbəttii	mi:ɖbətti
miiɖu~	miɖɖu~
mii~ɖhəɭə	mi~ɖʰəɭ
mii~ɖhu~	mi~ɳɖʰo
mukabəlo	mukablo
muktə	muktə
mukti	mukti
mukhəvasə	mukʰvas
mukhii	mukʰi
mukhjə	mukʰjə
mugəʈə	mugəʈ
muʈhʈhii	muʈʰʈʰi
mutərəɖii	mutərɖi
mudətə	mudət
muddələ	muddəl
muddo	muddo
mudrəkə	mudrək
mudra	mudra
muni	muni
munimə	munim
muphəlisə	mupʰlis
murəghii	murgʰi
murətijo	murətio
murəbbii	murəbbi
murəbbo	murəbbo
muradə	murad
muləkə	mulək
mulətəvii	mulətvi
muləvəɳii	muləvɳi
mulakatə	mulakat
mulajəmə	mulajəm
muʃkelə	muʃkel
muʃkelii	muʃkeli
musəddo	musəddo
musaphərə	musapʰər
musaphərii	musapʰəri
musiibətə	musibət
muslimə	muslim
mukəvu~	mukvu~
muu~gu~	mu˜gu
muchə	mucʰ
muʈhə	muʈʰ
muuɖii	muɖi
muutərə	mutər
muutərəvu~	mutərvu~
muutraʃəjə	mutraʃəj
muurəkhə	murəkʰ
muurtə	murtə
muurti	murti
muuləvəvu~	muləvvu~
muuljə	muljə
muuljə	muɭ
muuɭakʃərə	muɭakʃər
muuɭo	muɭo
muu~gu~	mu˜gu~
muu~ɟhəvəɳə	mu~ɟʰvəɳ
muuɟhavu~	mu~ɟʰavu~
mu~ɖəvu~	muɳɖvu~
mr≤utju~	mrutju~
mr≤udə~gə	mrudə˜g
meɖii	meɖi
metii	metʰi
methiipakə	metʰipak
methiiju~	metʰju~
medə	med
medənii	medni
medanə	medan
mena	mena
melə	m´l
melakhau~	m´lkʰau~
meləɖii	m´lɖi
meləvu~	melvu~
melu~	m´lu~
meʃə	m´~ʃ
meɭəvəɳə	meɭvəɳ
meɭəvəvu~	meɭəvvu~
meɭapə	meɭap
meɭavəɖo	meɭavɖo
meɭo	meɭo
me~	m´~
mokələvu	mokəlvu~
mokəɭaʃə	mokɭaʃ
mokəɭu~	mokɭu~
mokaɳə	mokaɳ
moko	møko
mokʃə	mokʃə
mogəro	mogro
mocəɳə	mocəɳ
mocii	moci
moɟəɖii	moɟɖi
moɟəməɟa	moɟməɟa
moɟəʃokhə	moɟʃokʰ
moɟu~	moɟu~
moɟudə	moɟud
moʈu~	moʈu~
moɖu~	moɖu~
moɖhu~	møɖʰu~
moɳə	moɳ
motə	møt
motijo	motijo
motii	moti
modii	modi
mobhə	mobʰ
mobhadarə	mobʰadar
morə	mor
morəco	morco
morəlii	morli
morəsə	morəs
morijo	mor(i)jo
morii	møri
molə	mol
movu~	movu~
mosəmə	mosəm
mosəmii	mosmi
mosə~bii	mosəmbi
mosaɭə	mosaɭ
mosaɭu~	mosaɭu~
mohə	moh
mohəkə	mohək
mohəvu~	mohvu~
moɭu~	møɭu~
mo~	mø~
mo~ghəvarii	mø~gʰvari
mo~ghu~	mø~˜gu~
	məun
məulvii	məulvi
məuliikə	məulik
mjanə	mjan
jəkr≤utə	jəkrut
jəɟəmanə	jəɟman
jəgnə	jəgnə
jəməduutə	jəmdut
jəʃə	jəʃ
jə~trə	jəntrə
jatəna	jatna
jatra	jatra
jadə	jad
jadii	jadi
janə	jan
jarə	jar
ja~trikə	ja~trik
jukti	jukti
jugə	jug
judhdhə	judʰdʰə
juvəkə	juvək
juvətii	juvti
juvəraɟə	juvraɟ
juvəragnii	juvragni
jogə	jogə
joganujogə	joganujog
joginii	jogini
jogii	jogi
jogjə	jogjə
joɟəkə	jo,ɟək
joɟəna	joɟna
joɟəvu~	joɟvu~
joni	joni
jəuvənə	jauban
rəkəmə	rəkəm
rəkabii	rəkabi
rəktə	rktə
rəkʃəkə	rəkʃək
rəkʃa	rəkʃa
rəkhəɖəvu~	rəkʰəɖvu~
rəkhəɖu~	rəkʰɖu~
rəkhatə	rəkʰat
rəkhe	rəkʰe
rəkhevaɭə	rəkʰevaɭ
rəgə	rəg
rəgəʃiju~	rəgəʃiju~
rəghəvaʈə	rəgvaʈ
rəcəna	rəcna
rəcəjita	rəcjita
rəcəvu~	rəcvu~
rəɟə	rəɟ
rəɟəkəɳə	rəɟkəɳ
rəɟəko	rəɟko
rəɟətə	rəɟət
rəɟənii	rəɟni
rəɟəputə	rəɟput
rəɟa	rəɟa
rəɟaii	rəɟai
rəɟaciʈhʈhii	rəɟaciʈʰʈʰi
rəʈəvu~	rəʈvu~
rəɖəvu~	rəɖvu~
rəɖaroɖə	rəɖaroɭ
rəɖhijaɭu~	rəɖʰijaɭu~
rəɳə	rəɳ
rəɳəkəvu~	rəɳəkvu~
rəɳəkarə	rəɳkar
rəɳəɟhəɳəvu~	rəɳɟʰəɳvu~
rətənə	rətən
rətələ	rətəl
rətəva	rətva
rətaʃə	rətaʃ
rətaɭu~	rətaɭu~
rəta~dhəɭu~	rəta~ndʰəɭu~
rətnə	rətnə
rəthə	rətʰ
rəddii	rəddi
rəbarii	rəbari
rəməkəɖu~	rəməkɖu~
rəməkhaɳə	rəmkʰaɳ
rəməɟhanə	rəmɟan
rəməɟhəʈə	rəmɟʰəʈ
rəmətə	rəmət
rəmətijaɭə	rəmətijaɭ
rəmərəməvu~	rəmrəmvu~
rəməvu~	rəmvu~
rəmuɟə	rəmuɟ
rəvərəvəvu~	rəvrəvvu~
rəvivarə	rəvivar
rəvo	rəvo
rəsə	rəs
rəsakəsii	rəsakəsi
rəsadarə	rəsadar
rəsajəɳə	rəsajəɳ
rəsikə	rəsik
rəsii	rəsi
rəsiidə	rəsid
rəso	rəso
rəsoiijo	rəsoijo
rəsoiijəɳə	rəsoijəɳ
rəsoii	rəsoi
rəsoɖu~	rəsoɖu~
rəsoɭii	rəsoɭi
	rəsto
rəssii	rəssi
rəhəsjə	rəhəsjə
rəheʈhaɳə	rəheʈʰaɳ
rəhevu~	rəhevu~
rəɭəvu~	rəɭvu~
rə~kə	rə˜k
rə~gə	rə˜g
rə~gəbhuumi	rə˜gəbʰumi
rə~gəɖhə~gə	rə˜gɖʰə˜g
rə~gəbhedə	rə˜bʰed
rə~gəlo	rə˜glo
rə~gəvu~	rə˜gvu~
rə~giinə	rə˜gin
raii	rai
rakʃəsə	rakʃəs
rakʃəsii	rakʃəsi
rakhə	rakʰ
rakhəɖii	rakʰɖi
rakhəvu~	rakʰvu~
rakhoɖiiju~	rakʰoɖiju~
ragə	rag
raɟə	raɟ
raɟəku~vərə	raɟku~vər
raɟəku~vərii	raɟku~vri
raɟəkarəɳə	raɟkarəɳ
raɟəkiijə	raɟkijə
raɟəkumarə	raɟkumar
raɟəgadii	raɟgadi
raɟədhanii	raɟdʰani
raɟəniiti	raɟniti
raɟənəitikə	raɟnəitik
raɟərəmətə	raɟrəmət
raɟa	raɟa
raɟii	raɟi
raɟjə	raɟjə
raɖə	raɖ
raɳii	raɳi
raɳiivasə	raɳivas
raɳo	əraɳo
ratə	rat
ratədivəsə	ratdi:vəs
ratəpaɭii	ratpaɭi
ratəvaso	ratvaso
ratu~	red
ratri	ratri
ranii	rani
raphəɖo	rapʰɖo
rabə	rab
raməɖholə	ramɖʰol
raməpatərə	rampatər
raməphəɭə	rampʰəɭ
raməbaɳə	rambaɳ
raməraɟjə	ramraɟjə
raməliila	ramlila
ramii	rami
ramo	ramo
rajəɳə	rajəɳ
ravəɳijo	ravəɳijo
ras°ʈrə	raʃʈrə
ras°ʃʈrijə	raʃʈrijə
rasə	ras
rasajəɳikə	rasajəɳik
rahətə	rahət
rahədarii	rahdari
rahəbərə	rahbər
rahuu	rahu
ra~dhəvu~	ra~dʰvu~
ribavəvu~	ribavvu~
rivaɟə	rivaɟ
risavu~	ri:savu~
riiɟhəvəvu~	riɟʰəvvu~
riiɖhu~	riɖʰu~
riitə	rit
riitəbhatə	ritbʰat
riitərivaɟə	ritrivaɟ
rii~gəɳə	ri˜gəɳ
rii~chə	ri~cʰ
ruabə	ruab
rucəvu~	rucvu~
ruci	ruci
rucikərə	rucikər
rudənə	rudən
rudhirə	rudʰir
ruu	ru
ruuɟhəvu~	ruɟʰvu~
ruuʈhəvu~	ruʈʰvu~
ruuɖu~	ruɖu~
ruuɖhə	ruɖʰ
ruuɖhi	ruɖʰi
ruupə	rup
ruupəkə	rupək
ruupərekha	ruprekʰa
ruupaɭu~	rupaɭu~
ruupa~tərə	rupa~ntər
ruupijo	rupijo
ruupu~	rupu~
ruubəruu	rubru
ruuməɟhuumə	rumɟʰum
ruumalə	rumal
ruu~dhəvu~	ru~dʰvu~
rekha	rekʰa
rekha~ʃə	reka~mʃ
recə	rec
reɖə	reɖ
reɖəvu~	reɖvu~
reɖhijaɭə	reɖʰijaɭ
reɖhu~	reɖʰu~
reɳə	reɳ
retii	reti
rebəɟhebə	rebɟʰeb
relə	rel
reləməchelə	reləmcʰel
relavu~	relavu~
relo	relo
reʃhəmə	reʃəm
resadarə	resadar
reso	reso
re~kəvu~	r´~kvu~
rokəɖə	rokəɖ
rokəɖiiju~	rokəɖiju~
rokə	rokvu~
rokaɳə	rokaɳ
rogə	rog
rogiju~	rogiju~
roɟə	roɟ
roɟəniiʃii	roɟniʃi
roɟəbəroɟə	roɟbəroɟ
roɟii	roɟi
roɟo	roɟo
roʈəlii	roʈli
rotələ	rotəl
ronəkə	ronək
ropəvu~	ropvu~
roma~cə	roma~µc
rovu~	rovu~
roɟənii	roʃni
ros°ə	roʃ
rəudrə	rəudrə
ləkəvo	ləkvo
ləkʃəɳə	ləkʃəɳ
ləkʃəmii	ləkʃmi
ləkhəpəti	ləkʰpəti
ləkhəluuʈə	ləkʰluʈ
ləkhəvu~	ləkʰvu~
ləkhaɳə	ləkʰaɳ
ləkhavəʈə	ləkʰavəʈ
ləkhoʈii	ləkʰoʈi
ləgəɖii	ləgɖi
ləgənə	ləgən
ləgəbhəgə	ləgbʰəg
ləgatarə	ləgatar
ləgamə	ləgam
ləgavəvu~	ləgavvu~
ləgii	ləgi
ləgoləgə	ləgoləg
ləgnə	ləgnə
ləghu	ləgʰu
ləghutəmə	ləgʰutəm
ləghumətii	ləgʰuməti
ləcəkəvu~	ləcəkvu~
ləcəko	ləcko
ləcəpəcə	ləcpəc
ləɟaməɳii	ləɟamɳi
ləɟavəvu~	ləɟavvu~
ləɟɟa	ləɟɟa
ləʈə	ləʈ
ləʈəkaɭu~	ləʈkaɭu~
ləʈəku~	ləʈku~
ləɖətə	ləɖət
ləɖəvu~	ləɖvu~
ləɖaii	ləɖai
ləɖajəkə	ləɖajək
ləɖhəɳə	ləɖʰəɳ
ləɳəvu~	ləɳvu~
lətə	lət
lətto	lətto
ləthəɖəvu~	lətʰəɖvu~
ləʈhəɖiiju~	lətʰəɖiju~
ləpəkəvu~	ləpəkvu~
ləpəkaro	ləpkaro
ləpəchəpə	ləpcʰəp
ləpəʈə	ləpəʈ
ləpəʈəvu~	ləpəʈvu~
ləpəɖakə	ləpɖak
ləpələpə	ləpləp
ləpəvu~	ləpvu~
ləpəsəvu~	ləpəsvu~
ləpavu~	ləpavu~
ləpeʈəvu~	ləpeʈvu~
ləpeɖəvu~	ləpeɖvu~
ləpeɖo	ləpeɖo
ləppəɖə	ləppəɖ
ləphəru~	ləpʰru~
ləbəɖəvu~	ləbəɖvu~
ləbaco	ləbaco
ləbaɖə	ləbaɖ
ləməɳaɟhikə	ləmɳaɟʰi~k
ləməɳu~	ləmɳu~
ləjə	ləj
lələkarə	ləlkar
lələkarəvu~	ləlkarvu~
lələcavəvu~	ləlcavu~
lələna	ləlna
	ləvro
ləvəvu~	ləvvu~
ləvaɟəmə	ləvaɟəm
ləvadii	ləvadi
ləvaru~	ləvaru~
ləvaro	ləvaro
ləvi~gə	ləvi˜g
ləvi~giju~	ləvi˜giju~
ləʃkərə	ləʃkər
ləsəɳə	ləsəɳ
ləsərəko	ləsərko
ləsoʈəvu~	ləsoʈvu~
ləhaɳii	ləhaɳi
ləhavo	ləhavo
ləhijo	ləhijo
ləherə	ləher
ləherii	ləheri
ləɭəvu~	ləɭvu~
lə~gəɖu~	lə˜gɖu~
lə~gəɖo	lə˜gɖo
lə~gərə	lə˜gər
lə~guurə	lə˜gur
lə~goʈiju~	lə˜goʈijo
lə~pəʈə	ləmpəʈ
lə~bəcorəsə	ləmbcorəs
lə~bodərə	ləmbodər
lakəɖii	lakɖi
lakəɖu~	lakɖu~
lakʃəɳikə	lakʃənik
lakhə	lakʰ
lakhu~	lakʰu~
lagə	lag
lagəɳii	lagɳi
lagətə	lagət
lagəvəgə	lagvəg
lagəvu~	lagvu~
lacarə	lacar
laɟə	laɟ
laʈhii	laʈʰi
laɖə	laɖ
laɖəkəvaju~	laɖəkvaju~
laɖəvo	laɖvo
laɖu	laɖu~
latə	lat
ladə	lad
ladəvu~	ladvu~
ladii	ladi
ladhəvu~	ladʰvu~
lapəʈə	lapəʈ
lapərəva	lapərva
lapəʃii	lapʃi
lapho	lapʰo
labhə	labʰ
lajəkə	lajək
lalə	lal
laləcə	laləc
laləcu~	lalcu~
laləsa	lalsa
lalaʃə	lalaʃ
lalima	lalima
lalii	lali
lavərii	lavri
lavəvu~	lavvu~
laʃə	laʃ
laɭə	laɭ
laɭo	laɭo
la~gəɳə	la~˜gəɳ
la~cə	la~c
la~bu~	la~bu~
likhitə	likʰit
liɟɟətə	liɟɟət
lipi	lipi
lilamə	lilam
lisoʈo	lisoʈo
li~gə	li˜gə
li~bu~	limbu~
li~buɖii	limbuɖi
li~boɭii	limboɭi
liikhə	likʰ
liicii	lici
liiʈii	liʈi
liiməɖii	limɖi
liiməɖo	limɖo
liiləmə	liləm
liila	lila
liilaləherə	lilaləher
liilaʃə	lilaʃ
liilu~	lilu~
liisu~	lisu~
lii~ʈə	li~ʈ
lii~ɖii	li~ɳɖi
lii~pəɳə	li~pəɳ
lii~pəvu~	li~pvu~
luccaii	luccai
luccu~	luccu~
luchəɳiju~	lucʰəɳiju~
luʈaru	luʈaru
luharə	luhar
luu~gii	lu˜gi
luu	lu
luukhəsə	lukʰəs
luukhu~	lukʰu~
luugəɖu~	lugɖu~
luchəvu~	lucʰvu~
luuʈə	luʈ
luuʈəvu~	luʈvu~
luuɳə	luɳ
luuɳo	luɳo
luumə	lum
luulii	luli
lulu~	lulu~
lekhə	lekʰ
lekhəkə	lekʰək
lekhənə	lekʰən
lekhu~	lekʰu~
lekhe	lekʰe
leɳədarə	l´ɳdar
leɳədeɳə	leɳdeɳ
lepə	lep
lepəvu~	lepvu~
lebasə	lebas
lebhagu~	lebʰagu
levadeva	levadeva
levu~	levu~
lokə	lok
lokəkətha	lokkətʰa
lokəgiitə	lokgit
lokəcərca	lokcərca
lokəɟiivənə	lokɟivən
lokəprijə	lokprijə
lokəbhogjə	lokbʰogjə
lokəmətə	lokmət
lokəʃahii	lokʃahi
l	lokhit
lokacarə	lokacar
lokokti	lokokti
lokottərə	lokottər
lokhə~ɖə	lokʰəɳɖ
locənə	locən
loco	loco
loʈə	loʈ
loʈəvu~	loʈvu~
loɖhii	loɖʰi
loɖhu~	loɖʰu~
lopə	lop
lopəvu~	lopvu~
lophərə	lopʰər
lobhə	lobʰ
lobhaməɳu~	lobʰamɳu~
lobhii	lobʰi
lohəcu~bəkə	lohcumbək
lohiijaɭə	lohijaɭ
lohii	lohi
lohiiukaɭo	lohiukaɭo
lohiilulhaɳə	lohiluhaɳ
lohiiva	lohiva
loɭiju~	loɭiju~
lo~do	lø~do
ləukikə	ləukik
vəkərəvu~	vəkərvu~
vəkəro	vəkro
vəkiilə	vəkil
vəktəvjə	vəktəvjə
vəkta	vəkta
vəkhətə	vəkʰət
vəkhaɳə	vəkʰaɳ
vəkhaɳəvu~	vəkʰaɳvu~
vəkharə	vəkʰar
vəkhoɖəvu~	vəkʰoɖvu~
vəgəɖau~	vəgɖau
vəgə/ɖo	vəgɖo
vəgərə	vəgər
vəgaɖəvu~	vəgaɖvu~
vəgere	vəgere
vəgo	vəgo
vəgovəvu~	vəgovvu~
vəgharə	vəgʰar
vəgharəvu~	vəgʰarvu~
vəcəgaɭo	vcgaɭo
vəcənə	vəcən
vəcəlu~	vəclu~
vəcce	vəcce
vachuʈəvu~	vəcʰuʈvu~
vacheru~	vəcʰeru~
vəcherii	vəcʰeri
vəchoɖəvu~	vəcʰoɖvu~
vəɟənə	vəɟən
vəʈə	vəʈ
vəʈəlavu~	vəʈlavu~
vəʈəhukəmə	vəʈhukəm
vəʈaɳa	vəʈaɳa
vəʈavə	vəʈav
vəʈavəvu~	vəʈavvu~
vəʈemargu	vəʈemargu
vəɖ	vəɖ
vəɖəvo	vəɖvo
vəɖəsəsəro	vəɖsəsro
vəɖəsasu	vəɖsasu~
vəɖiilə	vəɖil
vəɖe	vəɖe
vəɖhəvu~	vəɖʰvu~
vəɳəkərə	vəɳkər
vəɳəɟharə	vəɳɟar
vəɳəvu~	vəɳvu~
vəɳəsəvu~	vəɳəsvu~
vəɳaʈə	vəɳaʈ
vətənə	vətən
vətəni	vətni
vətii	vəti
vədə	vəd
vədənə	vədən
vəddii	vəddi
vədhə	vədʰ
vədhəvu~	vədʰvu~
vədhaii	vədʰai
vədha,məɳu~	vədʰamɳu~
vədharəvu~	vədʰarvu~
vədhare	vədʰare
vədhavəvu~	vədʰavvu~
vədhu	vədʰu
vədherəvu~	vədʰervu~
vənə	vən
vənəraɟə	vənraɟ
vənəspəti	vənəspəti
vəpəraʃə	vəpraʃ
vəphadarə	vəpʰadar
vəmənə	vəmən
vəməɭə	vəməɭ
vəjə	vəj
)0 /vəjovrudʰdʰə/ 	vəjovrudʰdʰə
vərə	vər
vərəkhə	vərəkʰ
vərəghoɖiija~	vərgʰoɖija~
vərəghoɖo	masc
vərəɳə	vərəɳ
vərəɳagiju~	vərɳagiju~
vərəɳii	vərɳi
vərətəvu~	vərətvu~
vərətaro	vərtaro
vərədanə	vərdan
vərəmaɭa	vərmaɭa
vərəraɟa	vərraɟa
vərəvu~	vərvu~
vərəsii	vərsi
vərəsə	vərəs
vərəsadə	vərsad
vəraɭə	vəraɭ
vərijaɭii	vərijaɭi
vəris°ʈhə	vəriʃʈʰə
vəru	vəru
vəreɖu~	vəreɖu~
vəro	vəro
vərgə	vərgə
vərcəsə	vərcəs
vərcəsvii	vərcəsvi
vərɳə	vərɳə
vərɳənə	vərɳən
vərɳəvəvu~	vərɳəvvu~
vərnanukrəmə	m 
vərtəɳu~kə	vərtəɳu~k
vərtənə	vərtən
vərtəmanə	vərtəman
vərtuɭə	vərtuɭ
vərs°ə	vərʃə
vvərs°ar≤utu	vərʃarutu
vələɳə	vələɳ
vəloɳu~	vəloɳu~
vəlopatə	vəlopat
vəlopatiju~	vəlopati,ju~
vəsəti	vəsti
vəsəvəso	vəsvəso
vəsəvaʈə	vəsvaʈ
vəsəvu~	vəsvu~
vəsə~tə	vəsənt
vəsaɳu~	vəsaɳu~
vəsavəvu~	vəsavvu~
vəsahətə	vəsahət
vəsijətə	vəsijət
vəsijətə	vəsijətnamu~
vəsukəvu~	vəsukvu~
vəsulatə	vəsulat
	vəstu
vəstrə	vəstrə
vəhaɳə	vəhaɳ
vəhalə	vəhal
vəhii	vəhi
vəhiivəʈə	vəhivəʈ
vəhiivəʈii	vəhivəʈi
vəhiivə~co	vəhivəµco
vəhu	vəhu
vəhemə	vəhem
vəhe,mii	vəhemi
vəhelu~	vəhelu~
vəhe,varə	vəhevar
vəhevaru~	vəhevaru~
vəhevu~	vəhevu~
vəheɭiju~	vəheɭiju~
vəheɭo	vəheɭo
vəhe~cəvu~	vəh´~cvu~
vəhorəvu~	vəhorvu~
vəɭə	vəɭ
vəɭəgəɳə	vəɭgəɳ
vəɭəgəvu~	vəɭəgvu~
vəɭəgaɖə	vəɭgaɖ
vəɭətərə	vəɭtər
vəɭəvu~	vəɭvu~
vəɭavəvu~	vəɭavvu~
vəɭa~kə	vəɭa~˜k
vəɭii	vəɭi
və~ʈoɭə	vəɳʈoɭ
və~ʈoɭiijo	vəɳʈoɭijo
və~təri	vəntəri
və~dənə	vəndən
və~dəna	vəndana
vəndo	vəndo
və~ʃə	vəmʃ
va	va
vakjə	vakjə
vagəvu~	vagvu~
vagoɭəvu~	vagoɭvu~
vaghə	vaʰ
vaghəɳə	vagʰəɳ
vacəkə	vacək
vacənə	əvacən
vacənaləjə	vacənaləj
vaca	vaca
vacjarthə	vacjartʰə
vachəɖii	vacʰɖi
vaɟə	vaɟ
vaɟapeʈii	vaɟapeʈi
vaɟi~trə	vaɟintrə
vaʈə	vaʈ
vaʈəvu~	vaʈvu~
vaʈaghaʈə	vaʈagʰaʈ
vaɖə	vaɖ
vaɖəkii	vaɖki
vaɖabə~dhii	vaɖabəndʰi
vaɖii	vaɖi
vaɖo	vaɖo
vaɖhə	vaɖʰ
vaɖhəvu~	vaɖʰvu~
vaɳiɟjə	vaɳiɟjə
vaɳijəɳə	vaɳijəɳ
vaɳijo	vaɳijo
vaɳii	vaɳi
vatə	vat
vatəcitə	vatcit
vatavərəɳə	vatavərəɳ
vatsəljə	vatsəljə
vadə	vad
vadəɭə	vadəɭ
vadəɭiju~	vadəɭiju~
vanə	van
vanəgii	vangi
vanərə	vanər
vaməɳu~	vamɳu~
vamənə	vaman
vajəɖaii	vajɖai
vajəɖu~	vajɖu~
vajədo	vajdo
vajəro	vajro
vajəvjə	vajəvjə
vaju~	vaju
varəvu~	varvu~
varəsə	varəs
varasagətə	varsagət
varəso	varso
varə~varə	varəmvar
varaphərətii	varapʰərti
varo	varo
varta	varta
vars°ikə	varʃik
valə	val
valoɭə	valoɭ
vavə	vav
vavəʈo	vavʈo
vavəɖə	vavəɖ
vavəɳii	vavɳi
	vavu~
vavetərə	vavetər
vasə	vas
vasəɳə	vasəɳ
vasəna	vasna
vasəvu~	vasvu~
vasii	vasi
vastəvə	vastəv
vastəvikə	vastəbik
vastu	vastu
vastupuuɟa	vastu puɟa
vahə	vah
vahənə	vahən
vahiatə	vahijat
vaɭə	vaɭ
vaɭəvu~	vaɭvu~
vaɭə~də	vaɭənd
vaɭii	vaɭi
vaɭo	vaɭo
va~kə	va~k
va~kəɖo	va~kɖo
va~ku~	va~ku~
va~ku~cuuku~	va~ku~cu~ku~
va~ghu~	va~gʰu~
va~cənə	va~cən
va~cəvu~	va~cvu~
va~ɟhəɳu~	va~ɟʰɳu~
va~ɖho	va~ɖʰo
va~dəro	va~dro
va~dərii	va~dri
va~dəru~	va~dru~
va~dho	va~dʰo
va~sə	va~s
va~sələɖii	va~səlɖi
va~səɭii	va~sɭi
va~so	va~so
vikəʈə	vikəʈ
vikəraɭə	vikraɭ
vikəlpə	vikəlpə
vikəsəvu~	vikəsvu~
vikəsitə	viksit
vikarə	vikar
vikarii	vikari
vikasə	vikas
vikr≤utə	vikrut
vikʃepə	vikʃep
vikhəvadə	vikʰvad
vikhuuʈu~	vikʰuʈu~
vikherəvu~	vikʰervu~
vikhjatə	vikʰjat
vigətə	vigət
vigrəhə	vigrəhə
vighəʈənə	vi:gʰəʈən
vighatəkə	vigʰatək
vighnə	vignə
vicəkʃəɳə	vicəkʃəɳ
vicərəvu~	vicərvu~
vicarə	vicar
vi,carəkə	vicarək
vicarəɳa	vicarɳa
vicarəvu~	vicarvu~
vicitrə	vicitrə
vicchedə	viccʰed
viɟəjə	viɟəj
viɟatiijə	viɟatijə
viɟeta	viɟeta
viɟogə	viɟog
vignanə	vignan
vignapəkə	vignapək
viʈə~bəɳa	viʈəmbɳa
viɖə~bənə	viɖambən
v	vitrəɳ
vitaɖəvu~	vitaɖvu~
vidajə	vidaj
v	vidit
vidus°ii	viduʃi
viduus°əkə	viduʃək
videʃə	videʃ
videʃii	videʃi
vidjəmanə	vidjəman
vidja	vidja
vidjapiiʈhə	vidjapiʈʰ
vidjarthii	vidjartʰi
vidjarthiinii	vidjartʰini
vidjutə	vidjut
vidrohə	vidroh
vidvəta	vidvəta
vidvanə	vidvan
vidhəva	vidʰva
vidhata	vidʰata
vidhatrii	vidʰatri
vidhanə	vidʰan
vidhajəkə	vidʰajək
vidhi	vidʰi
vidhurə	ivdʰur
vinəjə	vinəj
vinəvəɳi	vinəvɳi
vinə~tii	vinənti
vina	vina
vinaʃə	vinaʃ
vinaʃii	vinaʃi
viniməjə	vinimaj
vinodə	vinod
vipətti	vi:pətti
vipəthə	vipətʰ
vipəriitə	viprit
vipulə	vipul
viprə	viprə
vipləvə	vipləv
vibhəktə	vibʰəktə
vibhəkti	vibʰəkti
vibhagə	vibʰag
vibhaɟəkə	vibʰaɟək
v	vibʰaɟən
vibhaɟjə	vibʰaɟjə
vibhinnə	vibʰinnə
vibhuuti	vibʰuti
vimələ	viməl
vimanə	viman
vimukhə	vimukʰ
vijavu~	vijavu~
virəməvu~	virəmvu~
virəhə	virəh
viragii	viragi
viraʈə	viraʈ
viramə	viram
virodhə	virodʰ
viləkʃəɳə	viləkʃəɳ
	viləj
viləsəvu~	viləsvu~
vilapə	vilap
vilajətə	vilajət
vilajətii	vilajəti
vilavu~	vilavu~
vilasə	vilas
vivərəɳə	vivrəɳ
vivadə	vivad
vivahə	vivah
vividhə	vividʰ
vividhəta	vividʰta
vivekə	vivek
vivecəkə	vivecək
vivecənə	vivecən
vivecəna	vivecəna
viʃədə	viʃəd
	viʃaɭ
viʃis°ʈə	viʃiʃtə
viʃe	viʃe
viʃes°ə	viʃeʃ
viʃes°ətə:	viʃeʃtəh
viʃes°əta	viʃeʃta
viʃramə	visram
viʃleʃəɳə	viʃleʃəɳ
viʃvə	viʃvə
viʃvasə	ivʃvas
vis°ə	viʃ
vis°ədhərə	viʃdʰər
vis°əmə	viʃəm
vis°əjə	viʃəj
vis°əjantərə	viʃajantər
vis°adə	viʃad
visərgə	visərgə
visərɟənə	visərɟən
visamo	visamo
vistərəvu~	vistərvu~
vistarə	vistar
vistarəvu~	vistarvu~
visphoʈə	vispʰoʈ
visməjə	visməj
vismərəɳə	vismərəɳ
vihərəvu~	vihərvu~
viharə	vihar
vihiinə	vihin
vihvəɭə	vihvəɭ
viikhərəvu~	vikʰərvu~
viichəɭəvu~	vicʰəɭvu~
viiɟəɭii	viɟɭi
viiɳəvu~	viɳvu~
viiɳa	viɳa
viinəvəvu~	vinəvvu~
viiphərəvu~	vipʰərvu~
viimo	vimo
viirə	vir
viirəta	virta
viirjə	virjə
viiʃii	viʃi
vii~chii	vi~cʰi
vii~chəɳə	vi~cʰəɳ
viiɟəɳo	vi~ɟɳo
v	vi~ʈ,vu~
vii~ʈo	vi~ʈo
vii~dhəvu~	vi~dʰvu~
vr°ukʃə	vrukʃə
vr°udhdhə	vruddʰə
vr°udhdhi	vrudʰdʰi
vr°us°əɳə	vruʃəɳ
vegə	veg
vegəɭu~	vegɭu~
vecəvu~	vecvu~
vecaɳə	vecaɳ
veʈhəvu~	veʈʰvu~
veɖəphəvu~	veɖəpʰvu~
veɖəvu~	veɖvu~
veɖho	veɖʰo
veɳii	veɳi
vetənə	vetən
vetərəvu~	vetərvu~
vetaɭə	vetaɭ
vedəna	vedna
vedhəkə	vedʰək
vvedhəvu~	vedʰvu~
vedhəʃaɭa	vedʰʃaɭa
veparə	vepar
veparii	vepari
verə	v´r
verəɳəcherəɳə	verəɳcʰerəɳ
verəvu~	vervu~
veragii	veragi
veranə	veran
vero	vero
veləɳə	veləɳ
velo	velo
vevəlaii	vevlai
vevaii	vevai
veviʃaɭə	veviʃaɭ
veʃə	veʃ
veʃja	veʃja
vəikəlpikə	vəikəlpik
vəignanikə	vəignanik
vəidə	vəid
vəidhəvjə	vəidʰəvjə
vəiʃakhə	vəiʃakʰ
vəis°ɳəvə	vəiʃɳəv
vjəkti	vjəkti
vjəgrə	vjgrə
vjəgrata	ta 
vjəgrata	vjəgrəta
vjətha	vjətʰa
vjəbhicarə	vjəbʰicar
vjəbhicarii	vjəbʰicari
vjərthə	vjərtʰə
vjəvəsajə	vjəvsaj
vjəvəstha	vjəvəstʰa
vjəvəharə	vjəvhar
vəvəharəkuʃəɭə	vjəvharkuʃəɭ
vjəvəharu	vjəvharu
vjəsənə	vjəsən
vjəstə	vjəstə
vjə~gə	vjə˜gə
vjə~ɟənə	vjəµɟən
vjakərəɳə	vjakrəɳ
vjakhja	vjakʰja
vjakhjata	vjakʰjata
vjakhjanə	vjakʰjan
vjakhjanə	 <vjakhjanə>  neut  a 
vjaɟə	vjaɟ
vjadhi	vjadʰi
vjapə	vjap
vjapəkə	vjapək
vjaparə	vjapar
vjajamə	vjajam
vjutpətti	vjutpətti
vrətə	vrət
ʃəkə	ʃək
ʃəkədarə	ʃəkdar
ʃəkəmə~də	ʃəkmənd
ʃəkəro	ʃəkro
ʃəkəro	ʃəkvu~
ʃəkkəriju~	əʃəkkəriju~
ʃəkkələ	ʃəkkəl
ʃəkti	ʃəkti
ʃəkti/puuɟa	ʃəktipuɟa
ʃəkjə	ʃəkjə
ʃəkjta	ʃəkjəta
ʃəɳə	ʃəɳ
ʃəɳəgarə	ʃəɳgar
ʃətabdii	ʃətabdi
ʃətru	ʃətru
ʃəpəthə	ʃəpətʰ
ʃəbə	ʃəb
ʃəbdə	ʃəbdə
ʃəbdəkos°ə	ʃəbdakoʃ
ʃəməvu~	ʃəmvu~
ʃəjətanə	ʃəjtan
ʃərəɳə	ʃərəɳ
ʃərəɳagəti	ʃərɳagəti
ʃərəɳarthii	ʃərɳartʰi
ʃərəɳaii	ʃərɳai
ʃərətə	ʃərət
	ʃərdi
ʃərəbətə	ʃərbət
ʃərəmə	ʃərəm
ʃərəmavu~	ʃərmavu~
ʃərəmaɭə	ʃərmaɭ
ʃəraphə	ʃərapʰ
ʃəraphii	ʃərapʰi
ʃərabə	ʃərab
ʃərabii	ʃərabi
ʃəriphə	ʃəripʰ
	ʃərir
ʃəruuatə	ʃəruat
ʃəstrə	ʃəʃtrə
ʃəstrəkrija	ya 
ʃəstrəkrija	ʃəʃtrəkrija
ʃəhiidə	ʃəhid
ʃəhiidii	ʃəhidi
ʃəhenəʃahə	ʃəhenʃah
ʃəherə	ʃəher
ʃə~ka	ʃə˜ka
ʃə~kaʃilə	ʃə˜kaʃil
ʃə~kaspədə	ʃə˜kaspəd
ʃə~khə	ʃə˜kʰ
ʃakə	ʃak
ʃakaharii	ʃakahari
ʃakhə	ʃakʰ
ʃakha	ʃakʰa
ʃhaɳu~	ʃaɳu~
ʃapə	ʃap
ʃabaʃə	ʃabaʃ
ʃabdikə	ʃabdik
ʃajərə	ʃajər
ʃarəvu~	ʃarvu~
ʃariirikə	ʃaririk
ʃalə	ʃal
ʃasəkə	ʃaʃək
ʃasənə	ʃasən
ʃaʃtrə	ʃastrə
ʃastrarthə	ʃastrartʰə
ʃahəmr≤ugə	ʃahmrug
ʃahukarə	ʃahukar
ʃahuɖii	ʃahuɖi
ʃaɭa	ʃala
ʃa~tə	ʃa~nt
ʃikarə	ʃikar
ʃikarii	ʃikari
ʃikʃəkə	ʃikʃək
ʃikʃəɳə	ʃikʃəɳ
ʃikʃa	ʃikʃa
ʃikʃika	ʃikʃika
ʃikʃitə	ʃkʃit
ʃikhərə	ʃikʰər
ʃikhərə	ʃikʰəɳɖ
ʃikha	ʃikʰa
ʃikharə	ʃikʰau
ʃikhaməɳə	ʃikʰaməɳ
ʃithilə	ʃitʰil
ʃibirə	ʃibir
ʃijaɭə	ʃijaɭ
ʃijaɭu~	ʃijaɭu~
ʃijaɭo	ʃijaɭo
ʃirə	ʃir
ʃira	ʃira
ʃila	ʃila
ʃilpə	ʃilpə
ʃilpəʃastrə	ʃilpəʃastrə
ʃilpəʃastrii	ʃilpəʃastri
	ʃilpi
ʃivəratrii	ʃivratri
ʃiʃirə	ʃiʃir
ʃiʃu	ʃiʃu
ʃiʃnə	ʃiʃnə
ʃis°ʈacarə	ʃiʃtacar
ʃis°jə	ʃiʃjə
ʃis°ja	ʃiʃja
	ʃistə
ʃi~gə	ʃi˜g
ʃi~gəɖu~	ʃi˜gɖu~
ʃiikhə	ʃikʰ
ʃiikhəvu~	ʃikʰvu~
ʃiitəɭa	ʃitɭa
ʃiiro	ʃiro
ʃiiʃii	ʃiʃi
ʃiiʃo	ʃiʃo
ʃiiɭəva	ʃiɭva
ʃukənə	ʃukən
ʃukrəvarə	var 
ʃukrəvarə	ʃukrəvar
ʃudhdhə	ʃudʰdʰə
ʃudhdhi	ʃudʰdʰi
ʃubhə	ʃubʰ
ʃubhecchəkə	ʃubʰeccʰək
ʃubheccha	ʃubʰeccʰa
ʃuunjə	ʃunjə
ʃuurəviirə	ʃurvir
ʃuuɭə	ʃuɭ
ʃr≤u~garə	ʃru˜gar
ʃekəvu~	ʃekvu~
ʃeʈhə	ʃeʈʰ
ʃeʈhaɳii	ʃeʈʰaɳi
ʃetərə~ɟii	ʃetrənɟi
ʃerəɖii	ʃerɖi
ʃerii	ʃeri
ʃero	ʃero
ʃes°ə	ʃeʃ
ʃəili	ʃəili
ʃəiʃəvə	ʃəiʃəv
ʃokə	ʃok
ʃokhə	ʃokʰ
ʃodhə	ʃʰodʰ
ʃhobhəvu~	ʃobʰvu~
ʃobha	ʃobʰa
ʃjamə	ʃjam
ʃrədhdha	ʃrəddʰa
ʃrədhdhaɭu~	ʃrəddʰaɭu~
ʃrəvəɳə	ʃrəvəɳ
ʃravəɳə	ʃravəɳ
ʃrii	ʃri
ʃres°ʈhi	ʃreʃʈʰi
ʃrota	ʃrota
ʃlokə	ʃloka
ʃvanə	ʃvana
ʃvasə	ʃvasə
ʃvetə	ʃveta
s°əʈkərmə	ʃəʈkərmə
s°ətkoɳə	ʃəʈkoɳ
s°ətpədə	ʃəʈpəd
s°ə [dərʃənə	ʃəɖdərʃən
s°əs°ʈi	ʃəʃʈi
səii	səi
səkərməkə	səkərmək
səkəɭə	səkəɭ
səkə~ɟo	səkəµɟo
səkrijə	səkrijə
səkhəɳu~	səkʰɳu~
səkhavətə	səkʰavət
səkhi	səkʰi
səkhedə	səkʰed
səkhtə	səkʰtə
səkhtaii	səkʰtai
səgəɖə	səgəɖ
səgəɖə	səgpəɳ
səgərbha	səgərbʰa
səgəvəɖə	səgvəɖ
səgiirə	səgir
səguɳə	səguɳ
səgotrə	səgotrə
səghənə	səgʰən
səghəɭu~	səgʰɭu~
səcitrə	səcitrə
səcoʈə	səcoʈ
səccaii	səccai
səɟənii	səɟni
səɟəvu~	səɟvu~
səɟa	səɟa
səɟatiijə	səɟatijə
səɟavəʈə	səɟavəʈ
səɟiivə	səɟiv
səɟiivənə	səɟivən
səɟɟə	səɟɟə
səɟɟənə	səɟɟən
səʈiikə	səʈik
səʈoɖijo	səʈoɖijo
səʈosəʈə	səʈosəʈ
səʈʈo	səʈʈo
səɖəkə	səɖək
səɖəvu~	səɖvu~
səɖəsəʈhə	səɖsəʈʰ
səɖəsəɖaʈə	səɖsəɖaʈ
səɖo	səɖo
səɖhə	səɖʰ
səɳəko	səɳko
	sətət
sətaməɳii	sətaməɳi
səteɟə	səteɟ
sətkərmə	sətkərmə
sətkarə	sətkar
sətarəvu~	sətkarvu~
səttərə	səttər
sətta	sətta
səttavarə	səttavar
səttaɳu~	səttaɳu~
səttavənə	səttavən
səttavisə	səttavis
sətvə	sətvə
s	sətpuruʃ
sətjə	sətjə
sətjəvadii	sətjəvadi
sətjagrəhə	sətjagrəh
sətjanaʃə	sətjanaʃ
sətsə~gə	sətsə˜g
sədə~tərə	sədəntər
səda	səda
sədakaɭə	sədakaɭ
sədacərəɳə	sədacərəɳ
sədacarə	sədacar
sədii	sədi
sədgətə	sədgət
sədgəti	sədgəti
sədguɳə	sədguɳ
hS9 /sədgruhəstʰə/ 	sədgruhəstʰə
sədbudhdhi	sədbuddʰi
sədbhagii	sədbʰagi
sədbhagjə	sədbʰagjə
sədbhavə	sədbʰav
sədvru≤tti	sədvrutti
sədhdhərə	sədʰdʰər
sənəmə	sənəm
sənəsənaʈii	sənsənaʈi
sənatənə	sənatən
sənepatə	sənepat
sənmanə	sənman
sənmargə	sənmarg
sənmitrə	sənmitrə
səpəɖavəvu~	səpɖavvu~
səpənu~	səpnu~
səpərəmu~	səpərmu~
səpaʈə	səpaʈ
səpaʈii	səpaʈi
səpuucu~	səpucu~
səpuutə	səput
səptəkoɳə	səptəkøɳ
səptahə	səptah
səprəmaɳə	ma8 
səprəmaɳə	səprəmaɳ
səpremə	em 
səpremə	səprem
səphərə	səpʰər
səphərəɟənə	səpʰərɟən
səphəɭə	səpʰəɭ
səphaii	səpʰai
səphacəʈə	səpʰacəʈ
səphaɭu~	səpʰaɭu~
səphedə	səpʰed
səbəkə	səbək
səbəɖəko	səbəɖko
səbəɖəvu~	səbəɖvu~
səbəɭə	səbəɭ
səbhərə	səbʰər
səbha	səbʰa
səbhasədə	səpʰasad
səbhjə	səbʰjə
səmə	səm
səməkʃə	səməkʃə
səməgrə	səməgrə
səməcorəsə	səmcorəs
səməɟə	səməɟ
səməɟəɳə	səməɟəɳ
səməɟəɳu~	səməɟɳu~
səməɟəvu~	səməɟvu~
səməɟu	səmɟu
səməɟutii	səmɟuti
səmətələ	səmtəl
səmətula	səmtula
səmətolə	səmtol
səmədərʃii	səmdərʃi
səmədrəs°ʈi	səmdrəʃʈi
səməbhavə	səmbʰav
səməjə	səməj
səmərəvu~	səmərvu~
səməruupə	səmrup
səmərthə	səmərtʰə
səmərpəɳə	səmərpəɳ
səmərpəvu~	səmərpəvu~
səməʃerə	səmʃer
səməstə	sə
səməsja	səməsja
səmagəmə	səmagəm
səmacarə	səmacar
səmaɟə	səmaɟ
səmaɟəvadə	səmaɟvad
səmadhi	səmadʰi
səmanə	səman
səmanəta	səmanta
səmapənə	səmapən
səmaptə	səmaptə
səmarəvu~	səmarvu~
səmarə~bhə	səmarəmbʰə
səmaveʃə	səmaveʃ
səmasə	səmas
səma~tərə	səma~ntər
səmiti	səmiti
səmiikərəɳə	səmikərəɳ
səmikʃa	səmikʃa
səmiipə	səmip
səmiipəta	səmipta
səmiisa~ɟə	səmisa~ɟ
səmuucitə	səmucit
səmuuccəjə	səmuccəjə
səmuudajə	səmudaj
səmudrə	səmudrə
səmr≤dhdhə	səmrudʰdʰə
səmr≤dhdhi	səmrudʰdʰi
səmeʈəvu~	səmeʈvu~
səmovəɖu~	səmovəɖu~
sərəkəɳu~	sərəkɳu~
sərəkəvu~	sərəkvu~
sərəkarə	sərkar
sərəkarii	sərkari
sərəko	sərko
sərəkhavəvu~	sərkʰavvu~
sərəkhu~	sərkʰu~
sərəgəvo	sərgəvo
sərəghəsə	sərgʰəs
sərədarə	sərdar
sərədarii	sərdari
sərənamu~	sərnamu~
sərəpə~cə	sərpəµc
sərəpavə	sərpav
sərəbhərə	sərbʰər
sərəbhəra	sərbʰəra
sərəvaɭo	sərvaɭo
sərəvəiju~	sərvəiju~
sərəʃiju~	sərəʃiju~
sərəsə	sərəs
sərəsamanə	sərsaman
sərəhədə	sərhəd
sərəɭə	sərəɭ
sərəɭəta	sərəɭta
səravəvu~	səravvu~
səreraʃə	səreraʃ
səroɟə	səroɟ
səroɟinii	səroɟini
sərovərə	sərovər
sərɟəkə	sərɟək
sərɟənə	sərɟən
sərɟəvu~	sərɟvu~
sərvə	sərvə
sərva,grahii	ahI 
sərva,grahii	sərvəgrahi
sərvagnə	sərvəgnə
sərvatrə	sərvətrə
sərvənaʃə	sərvənaʃ
sərvənamə	sərvənam
sərvəbhəkʃii	sərvəbʰkʃi
sərvəmanjə	sərvəmanjə
sərvocjə	sərvoccə
səlaʈə	səlaʈ
səlamə	səlam
səlamətə	səlamət
səlamətii	səlaməti
səlahə	səlah
səlahəkarə	səlahkar
səvərɳə	səvərɳə
səvələtə	səvlət
səvəɭu~	əsəvɭu~
səva	səva
səvaju~	səvaju~
səvarə	səvar
səvarii	səvari
səvalə	səval
səvinəjə	səvinəj
səviʃes°ə	səviʃeʃ
səvistərə	səvistər
səveɭa	səveɭa
səʃəktə	səʃəktə
səsəro	səsro
səsəlu~	səslu~
səstu~	səstu~
səsnehə	səsneh
səhə	səh
səhəkarə	səhkar
səhəkarii	səhkari
səhəɟə	səhəɟ
səhəɟanə~də	səhɟanənd
səhənə	səhən
səhəbhagii	səhbʰagi
səhəmətə	səhmət
səhəməti	səhməti
səhəjogə	səhjog
səhəʃikʃəɳə	səhʃikʃəɳ
səhəsa	səhsa
səhajə	səhaj
səhijərə	səhijər
səhijaru~	səhijaru~
səhis°ɳu	səhiʃɳu
səhis°ɳuta	səhiʃɳuta
səhii	səhi
səheɟə	səheɟ
səhetəkə	səhetuk
səhelə	səhel
səhelu~	səhelu~
səhodərə	səhodər
səhjə	səhjə
səɭə	səɭ
səɭəgəvu~	səɭəgvu~
səɭəvəɭəvu~	səɭvəɭvu~
səɭə~gə	səɭə˜g
səɭijo	səɭijo
səɭii	səɭi
səɭekhəmə	səɭekʰəm
sə~kəʈə	sə˜kəʈ
sə~kələnə	sə˜kələn
sə~kəlpə	sə˜kəlpə
sə~kəɭavu~	sə˜kɭavu~
sə~kucitə	sə˜kucit
sə~kulə	sə˜kul
sə~ketə	sə˜ket
sə~keləvu~	sə˜kelvu~
sə~kocə	sə˜koc
sə~kocəvu~	sə˜kocvu~
səkorəvu~	sə˜korvu~
sə~kʃiptə	sə˜kʃiptə
sə~khja	sə˜kʰja
sə~gə	sə˜g
sə~gəʈhənə	sə˜gəʈʰən
sə~gəmə	sə˜gəm
sə~gathə	sə˜gatʰ
sə~giitə	sə˜git
sə~giinə	sə˜gin
sə~gemərəmərə	sə˜gemərmər
sə~grəhə	sə˜grəh
sə~grəhəvu~	hvu& 
sə~grəhəvu~	sə˜grəhvu~
sə~ghə	sə˜gə
sə~ghərəvu~	sə˜gərvu~
sə~ghərs°ə	səmgʰərʃ
sə~caləkə	səµcalək
sə~calika	səµcalika
sə~calənə	səµcalən
sə~co	səµco
sə~ɟogə	səµɟog
sə~gna	sə˜gna
sə~ɖasə	səɳɖas
sə~ɖo,vəvu~	səɳɖovvu~
sə~tə	sənt
sə~təvaɳi	səntvaɳi
sə~təru	səntru~
sə~takukəɖii	səntakukɖi
sə~taɖəvu~	səntaɖvu~
sə~tanə	səntan
sə~tapə	səntap
sə~tavu~	səntavu~
sə~tulənə	səntulən
sə~tos°ə	səntoʃ
sə~tos°ii	səntoʃi
sə~dərbhə	səndərbʰ
sə~digdhə	səndigdʰə
sə~deʃə	səndeʃ
sə~dehə	səndeh
sə~dhi	səndʰi
sə~dhikaɭə	səndʰikaɭ
sə~dhja	səndʰja
sə~nipatə	sənnipat
sə~nis°ʈhə	sənniʃʈʰ
sə~nis°ʈha	sənniʃʈʰa
sə~njasə	səmnjas
sə~njasii	səmjasi
sə~pə	səmp
sə~pətti	səmpətti
sə~pərkə	səmpərk
sə~padəkə	səmpadək
sə~padənə	səmpadən
sə~puurɳə	səmpurɳə
sə~prədajə	day 
sə~prədajə	səmprədaj
sə~bə~dhə	səmbəndʰə
sə~bə~dhii	səmbəndʰi
sə~bodhəvu~	səmbodʰvu~
sə~bodhəvu~	 <sə~bodhəvu~>  
sə~bhəvə	səmbʰəv
sə~bharəvu~	səmbʰarvu~
sə~bhavəna	səmbʰavna
sə~bhaɭə	səmbʰaɭ
sə~bhogə	səmbʰog
sə~mətə	səmmət
sə~məti	səmməti
sə~melənə	səmmelən
sə~melənə	 <sə~melənə>  neut  
sə~jəmə	səi~jəm
sə~juktə	səmjuktə
sə~jogə	səmjog
sə~joɟəkə	səmjoɟək
sə~joɟənə	səmjoɟən
sə~rəkʃəkə	səmrəkʃək
sə~rəkʃəɳə	səmrəkʃəɳ
sə~rəkʃəɳə	 <sə~rəkʃəɳə>  
sə~vətə	səmvət
sə~vətə	 <sə~vətə>  masc  the 
sə~vətsərii	səmvətsəri
sə~vənənə	səmvənən
sə~vənənə	 <sə~vənənə>  neut  
sə~vadə	səmvad
sə~vadə	 <sə~vadə>  masc  
sə~vadita	səmvadita
sə~vadii	səmvadi
sə~vedənə	səmvedən
sə~ʃəjə	səmʃəj
sə~ʃodhəkə	səmʃodʰək
sə~ʃodhənə	səmʃodʰən
sə~ʃodhitə	səmʃodʰit
sə~sərgə	səmsərg
sə~sarə	səmsar
sə~sarii	səmsari
sə~skarə	səmskar
sə~skariita	səmsarita
sə~skr≤tə	səmskut
sə~skr≤ti	səmskruti
sə~stha	səʃtʰa
sə~sthapəkə	səmstʰapək
sə~harə	səmhar
sə~harə	 <sə~harə>  masc  
sakərə	sakər
sakʃərə	sakʃər
sakʃat	sakʃat
sakʃatkarə	sakʃatkar
sakʃii	sakʃi
sagə	sag
sagərə	sagər
sacəvəvu~	sacəvvu~
sacu~	sacu~
saɟu~	saɟu~
saʈu~	saʈu~
saʈe	saʈe
saɖətriisə	saɖətris
saɖəlo	saɖlo
saɖii	saɖi
saɖasatii	saɖasati
saɖhu	saɖʰu
saɳəsii	saɳsi
satə	sat
satətjə	satətjə
satəmə	satəm
satəmu~	satmu~
sathə	satʰ
sathəɭə	satʰəɭ
saʈhijo	satʰijo
sakʃii	satʰi
sathiidarə	satʰidar
sadə	sad
sadəgii	sadgi
sadərə	sadər
sadaii	sadai
sadu~	sadu~
sadhəkə	sadʰək
sadhənə	sadʰən
sadhəna	sadʰna
sadhəvu~	sadʰvu~
sadharəɳə	sadʰarəɳ
sadhu	sadʰu
sadhvii	sadʰvi
sanə	san
sanukuuɭə	sanukuɭ
sapə	sap
sapəɳə	sapəɳ
sapekʃə	sapekʃə
sapoliju~	sapoliju~
saptahikə	saptahik
saphə	sapʰ
saphəsuuphə	sapʰsupʰ
sapho	sapʰo
sabədu~	sabdu~
sabərə	sabər
sabitii	sabiti
sabu	sabu
sabharə	sabʰar
saməgrii	saməgri
saməʈu~	samʈu~
saməno	samno
saməjikə	saməjik
samərthjə	samərtʰjə
samaɟiikə	samaɟik
samanə	saman
samanjə	samanjə
samanjətə:	samanjətəh
samudajikə	samudajik
samuuhikə	samuhik
same	same
saməiju~	saməiju~
samjə	samjə
samra,ɟjə	ajy 
samra,ɟjə	samraɟjə
sajuɟjə	sajuɟjə
sarə	sar
sarəvarə	sarvar
sarasə	sarəs
sarə~gii	sarə˜gi
sarasarii	sarasari
sara~ʃə	sara~mʃ
saru~	saru~
sarthəkə	sartʰək
sarvəɟənikə	sarvəɟənik
sarvətrikə	sarvətrik
salə	sal
saləbhərə	salbʰər
saləvu~	salvu~
salosalə	salosal
sallo	sallo
savə	sav
savəku~	savku~
savəcetə	savcet
savəcetii	savceti
savəɟə	savəɟ
savərəɳii	savərɳi
savərəɳo	savərɳo
sasəriju~	sasər(i)ju~
sasərii	sasri
sasu	sasu
sahəɟikə	sahɟik
sahəsə	sahəs
sahəsikə	sahsik
sahitjə	sahitjə
sahitjikə	sahitjik
sahebə	saheb
saheba	saheba
sahebii	sahebi
sahelii	saheli
saɭavelii	saɭaveli
saɭii	saɭi
saɭo	saɭo
sa~kəɖu~	sa~kɖu~
sa~kəɭə	sa~kəɭ
sa~kəɭəvu~	sa~kəɭvu~
sa~kəɭii	sa~kɭi
sa~kəɭu~	sa~kɭu~
sa~khəvu~	sa~kʰvu~
sa~ɟə	sa~ɟ
sa~ʈho	sa~ʈʰo
sa~dhəvu~	sa~dʰvu~
sa~dho	sa~dʰo
sa~prətə	sa~mprət
sa~prədajikə	daiyk 
sa~prədajikə	sa~prədajik
sa~belu~	sa~belu~
sa~bhɭəvu~	sa~bʰəɭvu~
sa~sarikə	sa~sarik
sa~sakarik	sa~nskarik
sa~skr≤tikə	sa~skrutik
sikko	sikko
sitəmə	sitəm
sitarə	sitar
sitaro	sitaro
sitterə	sitter
sitjoterə	sitjotər
sitjaʃii	sitjaʃi
sidhdhantə	sidʰdʰantə
sipaii	sipai
sipharəsə	sipʰarəs
siləkə	silək
silaii	silai
sivəɖaməɳə	sivɖaməɳ
sisəkarəvu~	siskarvu~
sisəkaro	siskaro
sisoʈii	sisoʈi
si~cəvu~	siµcvu~
si~durə	sindur
si~dhəvə	sindʰəv
si~dhii	sindʰi
si~hə	simh
si~həɳə	simhəɳ
si~hasənə	simhasən
siiɟhəvəvu~	siɟʰəvvu~
siiɟhəvu~	siɟʰvu~
siiʈii	siʈi
siiɖii	siɖi
siidhu~	sidʰu~
siimə	sim
siimə~tə	simənt
siima	sima
siimitə	simit
siivəɳə	sivəɳ
siivəvu~	sivvu~
sii~caii	siµcai
sukanə	sukan
sukanii	sukani
sukavu~	sukavu~
sukhə	sukʰ
sukhəɖə	sukʰəɖ
sukhəɖii	sukʰɖi
sukhii	sukʰi
sugəmə	sugəm
sugə~dhə	su:gəndʰ
suughəɖə	sugʰəɖ
suɖətaɭiisə	suɖtalis
suɖoɭə	suɖoɭ
sutərau~	sutrau
sudə	sud
sudhərəvu~	sudʰərvu~
sudhəraii	sudʰrai
sudha	sudʰa
sudharəvu~	sudʰarvu~
sudharo	sudʰaro
sudhii	sudʰi
sunavəɳii	sunavəɳi
supatrə	supatrə
subodhə	subodʰ
su,mənə	sumən
surəkʃitə	surəkʃit
suriilu~	surilu~
suruci	suruci
surekhə	surekʰ
suləbhə	suləbʰ
sulekhənə	sulekʰən
sulekhənə	 <sulekhənə>  neut  
sulehə	suleh
suvakjə	suvakjə
suvavəɖə	suvavəɖ
suvasə	suvas
suvikhjatə	suvikʰjat
suviditə	suvidit
suvidha	suvidʰa
suʃikʃitə	suʃikʃit
suʃilə	suʃil
suʃobhənə	suʃobʰən
suʃobhitə	ʃuʃobʰit
susəɟɟə	susəɟɟə
susəvaʈo	susvaʈo
susə~gətə	susə˜gət
sustə	sustə
	susti
su~dərə	sundər
suvaɭu~	suwaɭu~
suukəvəvu~	sukəvvu~
suku~	suku~
suukʃmə	sukʃmə
suugə	sug
suucəkə	sucək
suucənə	sucən
suucəvəvu~	sucəvvu~
suucəvəvu~	 <suucəvəvu~>  vtr  
suuci	suci
suucitə	sucit
suuɟəvu~	suɟvu~
suuɟhə	suɟʰ
suutəkə	sutək
suuməsamə	sumsam
suurə	sur
suurəɟə	surəɟ
suurəɳə	surəɳ
suurjə	surjə
suurjastə	surjastə
suurjodəjə	surjodəj
suuvərə	suvər
suuvu~	suvu~
suu~ghəvu~	su˜gvu~
suu~ʈhə	su~ʈʰ
suu~ɖhə	su~ɖʰ
sr≤s°ʈi	sruʃʈi
sena	sena
sevəkə	sevək
seva	seva
sevacakərii	sevacakri
se~kəɖo	s´~kɖo
se~thii	s´~tʰi
səinikə	səinik
səinjə	səinjə
so	sø
sogənə	sogən
sogatə	sogat
soɟo	soɟo
soʈii	soʈi
soɖə	soɖ
soɖəmə	soɖəm
sodagərə	sodagər
sodo	sodo
sonu~	sonu~
sonerii	soneri
soparii	sopari
sobətə	sobət
soməvarə	somvar
somələ	soməl
sojə	soj
sojo	sojo
sohagə	sohag
sohaməɳu~	sohaməɳu~
soɭə	soɭ
so~ghəvarii	sø~˜gvari
so~pəvu~	sø~pvu~
səu	səu
səuɟənjə	səuɟənjə
səubhagjə	səubʰagjə
səurəbhə	səurəbʰ
səu~dərjə	səu~dərjə
skhələnə	skʰələn
stənə	stən
stərə	stər
stəvənə	stəvən
stuti	stuti
stutjə	stutjə
stotrə	stotrə
strii	stri
striɳə	strəiɳə
sthəpəti	stʰəpəti
sthəɭə	stʰəɭ
sthanikə	stʰanik
sthapəkə	stʰapək
sthapətjə	stʰapətjə
sthajii	stʰaji
sthavərə	stʰavər
sthiti	stʰiti
sthirə	stʰir
snatəkə	snatək
snanə	snan
snaju	snehə
s	sneh
snehə	spərdʰa
spərʃə	spərʃə
spəs°ʈə	spəʃʈə
sphəʈiikə	spʰəʈik
smərəɳə	smərəɳ
smərəvu~	smərvu~
sməʃanə	ʃməʃan
smarəkə	smarək
smitə	smit
smr≤ti	smruti
svə	svə
svərgəsthə	svərgəstʰə
svəcchə	svəccʰə
svəɟənə	svəɟən
svətə~trə	svətəntrə
svətə~trəta	svətəntrəta
svədeʃə	svədeʃ
svədeʃii	svədeʃi
svepnə	svəpnə
svəbhavə	svəbʰav
svəmanə	svəman
svərə	svər
svəraɟə	svəraɟ
svəruupə	svərup
svərgə	svərgə
svərgəvasii	svərgəvasi
svərgiijə	svərgijə
svamii	svami
svarthə	svartʰə
svasthjə	svastʰjə
sviikarə	svikar
sviikarjə	svikarjə
həkə	hək
həkarə	həkar
həkiikətə	həkikət
həkiimə	həkim
həcəməcəvu~	həcməcvu~
həɟ	həɟ
həɟamə	həɟam
həɟarə	həɟar
həɟii	həɟi
həɟu	həɟu
həʈhə	həʈʰ
həʈhəvu~	həʈʰvu~
həɖəkəva	həɖəkva
həɖətalə	həɖtal
həɖədhuutə	həɖdʰut
həɖəpəcii	həɖpəci
həɖəseləvu~	həɖselvu~
həɳəvu~	həɳvu~
hətaʃə	hətaʃ
	hətja
hətjaro	hətjaro
həʈhijarə	hətʰijar
həʈheɭii	hətʰeɭi
həʈhoʈii	hətʰoʈi
h	hətʰoɖi
hədə	həd
həməɳa~	həmɳa~
həmədərdi	həmdərdi
həmalə	həmal
həmeʃə	həmeʃ
həjatə	həjat
hərəkətə	hərkət
hərəkhə	hərəkʰ
hərəgiɟə	hərgiɟ
hərəghəɖii	hərgʰəɖi
hərəɳə	hərəɳ
hərəsə	hərəs
həraɟii	həraɟi
həraju~	həraju~
hərii	həri
hərijaɭii	hərijaɭi
hərihərə	hərihər
həriiphə	həriʰp
həriphaii	həripʰai
hərekə	hərek
həroɭə	həroɭ
həlkaii	həlkai
hələku~	həlku~
hələvo	həlvo
həlavəvu~	həlavvu~
həlesu~	həlesu~
həvənə	həvən
həva	həva
həvamanə	həvaman
həvalədarə	həvaldar
həvalo	həvalo
həve	həve
həvethii	həvetʰi
həvelii	həveli
həʃe	həʃe
həsəvu~	həsvu~
həsaməɳu~	həsaməɳu~
həstəkəɭa	həstəkəɭa
həstəkʃepə	həstəkʃep
həstəprətə	həstəprət
həstəprətə	həstəmeɭap
həstakʃərə	həstakʃər
həɭə	həɭ
həɭədərə	həɭdər
həɭəvu~	həɭvu~
	həɭve
həɭəvethi	həɭvetʰi
hə~karəvu~	hə˜karvu~
hə~gamii	hə˜gami
hə~meʃə	həmmeʃ
hə~sə	həms
ha	ha
hakə	hak
haɟərə	haɟər
haɟərii	haɟri
haɖəku~	haɖku~
haɖəvəidə	haɖvəid
ha[amarii	haɖmari
haɖohaɖə	haɖohaɖ
hathə	hatʰ
hathəkəɖii	hatʰkəɖi
hathəɳii	hatʰɳi
hathii	hatʰi
hatho	hatʰo
hathohathə	hatʰohatʰ
ha na	ha na
hani	hani
hanikərta	hanikərta
harə	har
harəvu~	harvu~
halə	hal
haləcalə	halcal
halətə	halət
haləvu~	halvu~
haʃə	haʃ
hasjə	hasjə
hasjaspədə	hasjapəd
hahakarə	hahakar
ha~kəvu~	ha~kvu~
ha~ɟa	ha~ɟa
ha~phə	ha~pʰ
ha~phəvu~	ha~pʰvu~
ha~sijo	ha~s(i)jo
ha~sii	ha~si
hicəkaru~	hickaru~
hiɟəravu~	hiɟravu~
hitə	hit
hitecchu	hiteccʰu
hina	hina
himə	him
hiləcalə	hilcal
hisabə	hisab
hihabəniiʃə	hisabniʃ
hisso	hisso
hi~gə	hi˜gə
hi~mətə	himmət
hi~səkə	himsək
hi~sa	himsa
hiiɟəɖo	hiɟɖo
hiibəkəvu~	hibəkvu~
hiibəku~	hibku~
hiiro	hiro
hii~cəvu~	hi~cvu~
huukəmə	hukəm
hukko	hukko
huməlo	humlo
hulləɖə	hulləɖ
hu~	hu~
huuko	huko
huu~ɖii	hu~ɳɖi
huu~phə	hu~pʰ
hrədəjə	rədəj
hrədəjəʃunjə	rədəjʃunjə
hetə	het
hetu	hetu
heranəgəti	heran,gəti
helii	heli
hevanijətə	hevanijət
h	heval
hesijətə	hesjət
hoɟə	hiɟ
hoɟərii	hoɟri
hoʈhə	hoʈʰ
hoɖii	hoɖi
hoddo	hoddo
honəharə	honhar
honarətə	honarət
homə	hom
holo	holo
hovu~	hovu~
hoʃijarə	hoʃijar
hoʃijarii	hoʃijari
hoha	hoha
hoɭii	hoɭi
kʃəɳə	kʃəɳ
kʃəti	kʃəti
kʃətrijə	kʃətrijə
kʃəma	kʃəma
kʃə/mapatrə	kʃəmapatrə
kʃəjə	kʃəjə
kʃarə	kʃar
kʃitiɟə	kʃitiɟ
kʃetrə	kʃetrə
kʃetrəphəɭə	kʃetrəpʰəɭ
kʃobhə	kʃobʰ
gnati	gnjati
gnanə	gnan
gnanii	gnani
  	  
pa kr=o@ Ê bapu@ bhar gam gya 2e kale Aav=e 355 Tag-marks Gujarati has two types of tag-marks:(1) Sentence initial tag-marks, and (2) Sentence final tag-marks Examples: Sentence Initial tag-marks 	 calo Tyare  Express parting Phatic 10 h&, =u&  Express question 11 h&A, ha,  Express permission 12 W&hu&  Expresses negation  353  Negators na, nhI&, n and n9I are the negators in Gujarati We use negators to prohibit an action and also to negate a sentence or a phrase Examples: Prohibitative Negation  É tme kerI na `ata Ê tme bIju b0u& j `ajo, p8 kerI nhI& `ata Ë tme kerI n `aAo to saru& Sentential
